"","parliamentary_group_name","NR","SR","BV","date","parliament_number"
"3","Radikal-demokratische Gruppe (R)",112,25,137,"4 December 1912","22"
"4","Katholisch-Konservative Gruppe (K)",38,16,54,"4 December 1912","22"
"5","Sozialdemokratische Gruppe (S)",17,1,18,"4 December 1912","22"
"6","Liberal-demokratische Gruppe (L)",13,1,14,"4 December 1912","22"
"7","Sozialpolitische Gruppe (SPOL)",4,1,5,"4 December 1912","22"
"8","ohne Parteiangehörigkeit",4,0,4,"4 December 1912","22"
"9","nicht besetzte Sitze",1,0,1,"4 December 1912","22"
"10","total",189,44,233,"4 December 1912","22"
"14","Radikal-demokratische Gruppe (R)",112,23,135,"4 June 1913","22"
"15","Katholisch-Konservative Gruppe (K)",38,15,53,"4 June 1913","22"
"16","Sozialdemokratische Gruppe (S)",18,1,19,"4 June 1913","22"
"17","Liberal-demokratische Gruppe (L)",13,2,15,"4 June 1913","22"
"18","Sozialpolitische Gruppe (SPOL)",5,0,5,"4 June 1913","22"
"19","ohne Parteiangehörigkeit",3,2,5,"4 June 1913","22"
"20","nicht besetzte Sitze",0,1,1,"4 June 1913","22"
"21","total",189,44,233,"4 June 1913","22"
"25","Radikal-demokratische Gruppe (R)",112,23,135,"3 December 1913","22"
"26","Katholisch-Konservative Gruppe (K)",38,16,54,"3 December 1913","22"
"27","Sozialdemokratische Gruppe (S)",18,1,19,"3 December 1913","22"
"28","Liberal-demokratische Gruppe (L)",13,2,15,"3 December 1913","22"
"29","Sozialpolitische Gruppe (SPOL)",5,0,5,"3 December 1913","22"
"30","ohne Parteiangehörigkeit",3,1,4,"3 December 1913","22"
"31","nicht besetzte Sitze",0,1,1,"3 December 1913","22"
"32","total",189,44,233,"3 December 1913","22"
"36","Radikal-demokratische Gruppe (R)",109,24,133,"17 March 1914","22"
"37","Katholisch-Konservative Gruppe (K)",38,16,54,"17 March 1914","22"
"38","Sozialdemokratische Gruppe (S)",18,1,19,"17 March 1914","22"
"39","Liberal-demokratische Gruppe (L)",14,2,16,"17 March 1914","22"
"40","Sozialpolitische Gruppe (SPOL)",5,0,5,"17 March 1914","22"
"41","ohne Parteiangehörigkeit",4,1,5,"17 March 1914","22"
"42","nicht besetzte Sitze",1,0,1,"17 March 1914","22"
"43","total",189,44,233,"17 March 1914","22"
"47","Radikal-demokratische Gruppe (R)",111,24,135,"17 December 1914","23"
"48","Katholisch-Konservative Gruppe (K)",37,16,53,"17 December 1914","23"
"49","Sozialdemokratische Gruppe (S)",19,1,20,"17 December 1914","23"
"50","Liberal-demokratische Gruppe (L)",15,2,17,"17 December 1914","23"
"51","Sozialpolitische Gruppe (SPOL)",3,1,4,"17 December 1914","23"
"52","ohne Parteiangehörigkeit",4,0,4,"17 December 1914","23"
"53","nicht besetzte Sitze",0,0,0,"17 December 1914","23"
"54","total",189,44,233,"17 December 1914","23"
"58","Radikal-demokratische Gruppe (R)",109,24,133,"10 June 1915","23"
"59","Katholisch-Konservative Gruppe (K)",37,16,53,"10 June 1915","23"
"60","Sozialdemokratische Gruppe (S)",19,1,20,"10 June 1915","23"
"61","Liberal-demokratische Gruppe (L)",15,2,17,"10 June 1915","23"
"62","Sozialpolitische Gruppe (SPOL)",3,1,4,"10 June 1915","23"
"63","ohne Parteiangehörigkeit",5,0,5,"10 June 1915","23"
"64","nicht besetzte Sitze",1,0,1,"10 June 1915","23"
"65","total",189,44,233,"10 June 1915","23"
"69","Radikal-demokratische Gruppe (R)",110,24,134,"16 December 1915","23"
"70","Katholisch-Konservative Gruppe (K)",38,16,54,"16 December 1915","23"
"71","Sozialdemokratische Gruppe (S)",19,1,20,"16 December 1915","23"
"72","Liberal-demokratische Gruppe (L)",14,2,16,"16 December 1915","23"
"73","Sozialpolitische Gruppe (SPOL)",3,1,4,"16 December 1915","23"
"74","ohne Parteiangehörigkeit",5,0,5,"16 December 1915","23"
"75","nicht besetzte Sitze",0,0,0,"16 December 1915","23"
"76","total",189,44,233,"16 December 1915","23"
"80","Radikal-demokratische Gruppe (R)",110,24,134,"19 June 1916","23"
"81","Katholisch-Konservative Gruppe (K)",37,16,53,"19 June 1916","23"
"82","Sozialdemokratische Gruppe (S)",19,1,20,"19 June 1916","23"
"83","Liberal-demokratische Gruppe (L)",14,2,16,"19 June 1916","23"
"84","Sozialpolitische Gruppe (SPOL)",3,1,4,"19 June 1916","23"
"85","ohne Parteiangehörigkeit",5,0,5,"19 June 1916","23"
"86","nicht besetzte Sitze",1,0,1,"19 June 1916","23"
"87","total",189,44,233,"19 June 1916","23"
"91","Radikal-demokratische Gruppe (R)",109,24,133,"19 December 1916","23"
"92","Katholisch-Konservative Gruppe (K)",38,15,53,"19 December 1916","23"
"93","Sozialdemokratische Gruppe (S)",18,1,19,"19 December 1916","23"
"94","Liberal-demokratische Gruppe (L)",14,2,16,"19 December 1916","23"
"95","Sozialpolitische Gruppe (SPOL)",3,1,4,"19 December 1916","23"
"96","ohne Parteiangehörigkeit",7,0,7,"19 December 1916","23"
"97","nicht besetzte Sitze",0,1,1,"19 December 1916","23"
"98","total",189,44,233,"19 December 1916","23"
"102","Radikal-demokratische Gruppe (R)",109,24,133,"11 June 1917","23"
"103","Katholisch-Konservative Gruppe (K)",38,16,54,"11 June 1917","23"
"104","Sozialdemokratische Gruppe (S)",17,1,18,"11 June 1917","23"
"105","Liberal-demokratische Gruppe (L)",14,2,16,"11 June 1917","23"
"106","Sozialpolitische Gruppe (SPOL)",3,1,4,"11 June 1917","23"
"107","ohne Parteiangehörigkeit",8,0,8,"11 June 1917","23"
"108","nicht besetzte Sitze",0,0,0,"11 June 1917","23"
"109","total",189,44,233,"11 June 1917","23"
"113","Radikal-demokratische Gruppe (R)",102,24,126,"20 December 1917","24"
"114","Katholisch-Konservative Gruppe (K)",42,16,58,"20 December 1917","24"
"115","Sozialdemokratische Gruppe (S)",19,1,20,"20 December 1917","24"
"116","Liberal-demokratische Gruppe (L)",12,2,14,"20 December 1917","24"
"117","Sozialpolitische Gruppe (SPOL)",6,1,7,"20 December 1917","24"
"118","ohne Parteiangehörigkeit",7,0,7,"20 December 1917","24"
"119","nicht besetzte Sitze",1,0,1,"20 December 1917","24"
"120","total",189,44,233,"20 December 1917","24"
"124","Radikal-demokratische Gruppe (R)",103,24,127,"10 June 1918","24"
"125","Katholisch-Konservative Gruppe (K)",42,16,58,"10 June 1918","24"
"126","Sozialdemokratische Gruppe (S)",19,1,20,"10 June 1918","24"
"127","Liberal-demokratische Gruppe (L)",12,2,14,"10 June 1918","24"
"128","Sozialpolitische Gruppe (SPOL)",6,1,7,"10 June 1918","24"
"129","ohne Parteiangehörigkeit",7,0,7,"10 June 1918","24"
"130","nicht besetzte Sitze",0,0,0,"10 June 1918","24"
"131","total",189,44,233,"10 June 1918","24"
"134","Radikal-demokratische Gruppe (R)",101,23,124,"16 December 1918","24"
"135","Katholisch-Konservative Gruppe (K)",40,16,56,"16 December 1918","24"
"136","Sozialdemokratische Gruppe (S)",19,1,20,"16 December 1918","24"
"137","Liberal-demokratische Gruppe (L)",13,2,15,"16 December 1918","24"
"138","Sozialpolitische Gruppe (SPOL)",6,1,7,"16 December 1918","24"
"139","ohne Parteiangehörigkeit",7,0,7,"16 December 1918","24"
"140","nicht besetzte Sitze",3,1,4,"16 December 1918","24"
"141","total",189,44,233,"16 December 1918","24"
"145","Radikal-demokratische Gruppe (R)",84,19,103,"12 June 1919","24"
"146","Radikaldemokraten die der Gruppe nicht angehören",18,5,23,"12 June 1919","24"
"147","Katholisch-Konservative Gruppe (K)",41,16,57,"12 June 1919","24"
"148","Sozialdemokratische Gruppe (S)",19,1,20,"12 June 1919","24"
"149","Liberal-demokratische Gruppe (L)",12,2,14,"12 June 1919","24"
"150","Sozialpolitische Gruppe (SPOL)",7,1,8,"12 June 1919","24"
"151","ohne Parteiangehörigkeit",7,0,7,"12 June 1919","24"
"152","nicht besetzte Sitze",1,0,1,"12 June 1919","24"
"153","total",189,44,233,"12 June 1919","24"
"157","Radikal-demokratische Gruppe (R)",63,23,86,"22 December 1919","25"
"158","Katholisch-Konservative Gruppe (K)",41,17,58,"22 December 1919","25"
"159","Sozialdemokratische Gruppe (S)",41,0,41,"22 December 1919","25"
"160","Bauern-, Gewerbe- und Bürgergruppe (B)",25,1,26,"22 December 1919","25"
"161","Liberal-demokratische Gruppe (L)",9,2,11,"22 December 1919","25"
"162","Sozialpolitische Gruppe (SPOL)",7,1,8,"22 December 1919","25"
"163","ohne Parteiangehörigkeit",3,0,3,"22 December 1919","25"
"164","total",189,44,233,"22 December 1919","25"
"168","Radikal-demokratische Gruppe (R)",61,23,84,"18 June 1920","25"
"169","Katholisch-Konservative Gruppe (K)",41,17,58,"18 June 1920","25"
"170","Sozialdemokratische Gruppe (S)",41,0,41,"18 June 1920","25"
"171","Bauern-, Gewerbe- und Bürgergruppe (B)",28,1,29,"18 June 1920","25"
"172","Liberal-demokratische Gruppe (L)",9,2,11,"18 June 1920","25"
"173","Sozialpolitische Gruppe (SPOL)",7,1,8,"18 June 1920","25"
"174","ohne Parteiangehörigkeit",2,0,2,"18 June 1920","25"
"175","total",189,44,233,"18 June 1920","25"
"179","Radikal-demokratische Gruppe (R)",61,22,83,"16 December 1920","25"
"180","Katholisch-Konservative Gruppe (K)",41,17,58,"16 December 1920","25"
"181","Sozialdemokratische Gruppe (S)",41,0,41,"16 December 1920","25"
"182","Bauern-, Gewerbe- und Bürgergruppe (B)",28,1,29,"16 December 1920","25"
"183","Liberal-demokratische Gruppe (L)",9,2,11,"16 December 1920","25"
"184","Sozialpolitische Gruppe (SPOL)",7,0,7,"16 December 1920","25"
"185","ohne Parteiangehörigkeit",2,2,4,"16 December 1920","25"
"186","total",189,44,233,"16 December 1920","25"
"190","Radikal-demokratische Gruppe (R)",59,22,81,"13 June 1921","25"
"191","Katholisch-Konservative Gruppe (K)",41,17,58,"13 June 1921","25"
"192","Sozialdemokratische Gruppe (S)",38,0,38,"13 June 1921","25"
"193","Bauern-, Gewerbe- und Bürgergruppe (B)",31,1,32,"13 June 1921","25"
"194","Liberal-demokratische Gruppe (L)",9,2,11,"13 June 1921","25"
"195","Sozialpolitische Gruppe (SPOL)",6,1,7,"13 June 1921","25"
"196","Kommunistische Gruppe (Ko)",3,0,3,"13 June 1921","25"
"197","ohne Parteiangehörigkeit",2,0,2,"13 June 1921","25"
"198","total",189,43,232,"13 June 1921","25"
"202","Radikal-demokratische Gruppe (R)",59,22,81,"17 December 1921","25"
"203","Katholisch-Konservative Gruppe (K)",41,17,58,"17 December 1921","25"
"204","Sozialdemokratische Gruppe (S)",39,0,39,"17 December 1921","25"
"205","Bauern-, Gewerbe- und Bürgergruppe (B)",31,1,32,"17 December 1921","25"
"206","Liberal-demokratische Gruppe (L)",9,2,11,"17 December 1921","25"
"207","Sozialpolitische Gruppe (SPOL)",6,1,7,"17 December 1921","25"
"208","Kommunistische Gruppe (Ko)",0,0,0,"17 December 1921","25"
"209","ohne Parteiangehörigkeit",4,1,5,"17 December 1921","25"
"210","total",189,44,233,"17 December 1921","25"
"214","Radikal-demokratische Gruppe (R)",59,22,81,"19 June 1922","25"
"215","Katholisch-Konservative Gruppe (K)",41,17,58,"19 June 1922","25"
"216","Sozialdemokratische Gruppe (S)",38,0,38,"19 June 1922","25"
"217","Bauern-, Gewerbe- und Bürgergruppe (B)",31,1,32,"19 June 1922","25"
"218","Liberal-demokratische Gruppe (L)",9,2,11,"19 June 1922","25"
"219","Sozialpolitische Gruppe (SPOL)",6,1,7,"19 June 1922","25"
"220","Kommunistische Gruppe (Ko)",3,0,3,"19 June 1922","25"
"221","ohne Parteiangehörigkeit",2,1,3,"19 June 1922","25"
"222","total",189,44,233,"19 June 1922","25"
"226","Radikal-demokratische Fraktion (R)",58,23,81,"22 December 1922","26"
"227","Katholisch-Konservative Fraktion (K)",44,17,61,"22 December 1922","26"
"228","Sozialdemokratische Fraktion (S)",43,1,44,"22 December 1922","26"
"229","Bauern-, Gewerbe- und Bürgerfraktion (B)",35,1,36,"22 December 1922","26"
"230","Liberal-demokratische Fraktion (L)",10,1,11,"22 December 1922","26"
"231","Sozialpolitische Fraktion (SPOL)",3,1,4,"22 December 1922","26"
"232","ohne Fraktionsangehörigkeit",5,0,5,"22 December 1922","26"
"233","total",198,44,242,"22 December 1922","26"
"237","Radikal-demokratische Fraktion (R)",58,22,80,"18 June 1923","26"
"238","Katholisch-Konservative Fraktion (K)",44,18,62,"18 June 1923","26"
"239","Sozialdemokratische Fraktion (S)",43,1,44,"18 June 1923","26"
"240","Bauern-, Gewerbe- und Bürgerfraktion (B)",34,1,35,"18 June 1923","26"
"241","Liberal-demokratische Fraktion (L)",10,1,11,"18 June 1923","26"
"242","Sozialpolitische Fraktion (SPOL)",3,1,4,"18 June 1923","26"
"243","ohne Fraktionsangehörigkeit",6,0,6,"18 June 1923","26"
"244","total",198,44,242,"18 June 1923","26"
"248","Radikal-demokratische Fraktion (R)",58,22,80,"28 December 1923","26"
"249","Katholisch-Konservative Fraktion (K)",44,18,62,"28 December 1923","26"
"250","Sozialdemokratische Fraktion (S)",43,1,44,"28 December 1923","26"
"251","Bauern-, Gewerbe- und Bürgerfraktion (B)",34,1,35,"28 December 1923","26"
"252","Liberal-demokratische Fraktion (L)",10,1,11,"28 December 1923","26"
"253","Sozialpolitische Fraktion (SPOL)",3,1,4,"28 December 1923","26"
"254","ohne Fraktionsangehörigkeit",6,0,6,"28 December 1923","26"
"255","total",198,44,242,"28 December 1923","26"
"259","Radikal-demokratische Fraktion (R)",58,22,80,"18 June 1924","26"
"260","Katholisch-Konservative Fraktion (K)",43,18,61,"18 June 1924","26"
"261","Sozialdemokratische Fraktion (S)",42,1,43,"18 June 1924","26"
"262","Bauern-, Gewerbe- und Bürgerfraktion (B)",34,1,35,"18 June 1924","26"
"263","Liberal-demokratische Fraktion (L)",10,1,11,"18 June 1924","26"
"264","Sozialpolitische Fraktion (SPOL)",3,1,4,"18 June 1924","26"
"265","ohne Fraktionsangehörigkeit",6,0,6,"18 June 1924","26"
"266","nicht besetzte Sitze",2,0,0,"18 June 1924","26"
"267","total",198,44,242,"18 June 1924","26"
"271","Radikal-demokratische Fraktion (R)",58,22,80,"13 December 1924","26"
"272","Katholisch-Konservative Fraktion (K)",44,18,62,"13 December 1924","26"
"273","Sozialdemokratische Fraktion (S)",43,1,44,"13 December 1924","26"
"274","Bauern-, Gewerbe- und Bürgerfraktion (B)",34,1,35,"13 December 1924","26"
"275","Liberal-demokratische Fraktion (L)",10,1,11,"13 December 1924","26"
"276","Sozialpolitische Fraktion (SPOL)",3,1,4,"13 December 1924","26"
"277","ohne Fraktionsangehörigkeit",6,0,6,"13 December 1924","26"
"278","total",198,44,242,"13 December 1924","26"
"282","Radikal-demokratische Fraktion (R)",58,22,80,"18 June 1925","26"
"283","Katholisch-Konservative Fraktion (K)",43,17,60,"18 June 1925","26"
"284","Sozialdemokratische Fraktion (S)",43,1,44,"18 June 1925","26"
"285","Bauern-, Gewerbe- und Bürgerfraktion (B)",34,1,35,"18 June 1925","26"
"286","Liberal-demokratische Fraktion (L)",10,1,11,"18 June 1925","26"
"287","Sozialpolitische Fraktion (SPOL)",3,1,4,"18 June 1925","26"
"288","ohne Fraktionsangehörigkeit",6,0,6,"18 June 1925","26"
"289","nicht besetzte Sitze",1,1,2,"18 June 1925","26"
"290","total",198,44,242,"18 June 1925","26"
"294","Radikal-demokratische Fraktion (R)",59,21,80,"17 December 1925","27"
"295","Katholisch-Konservative Fraktion (K)",42,17,59,"17 December 1925","27"
"296","Sozialdemokratische Fraktion (S)",49,2,51,"17 December 1925","27"
"297","Bauern-, Gewerbe- und Bürgerfraktion (B)",30,1,31,"17 December 1925","27"
"298","Liberal-demokratische Fraktion (L)",7,1,8,"17 December 1925","27"
"299","Sozialpolitische Fraktion (SPOL)",5,1,6,"17 December 1925","27"
"300","Kommunistische Fraktion (Ko)",3,0,3,"17 December 1925","27"
"301","ohne Fraktionsangehörigkeit",3,0,3,"17 December 1925","27"
"302","nicht besetzte Sitze",0,1,1,"17 December 1925","27"
"303","total",198,44,242,"17 December 1925","27"
"307","Radikal-demokratische Fraktion (R)",59,22,81,"14 June 1926","27"
"308","Katholisch-Konservative Fraktion (K)",42,17,59,"14 June 1926","27"
"309","Sozialdemokratische Fraktion (S)",49,2,51,"14 June 1926","27"
"310","Bauern-, Gewerbe- und Bürgerfraktion (B)",30,1,31,"14 June 1926","27"
"311","Liberal-demokratische Fraktion (L)",7,1,8,"14 June 1926","27"
"312","Sozialpolitische Fraktion (SPOL)",5,1,6,"14 June 1926","27"
"313","Kommunistische Fraktion (Ko)",3,0,3,"14 June 1926","27"
"314","ohne Fraktionsangehörigkeit",3,0,3,"14 June 1926","27"
"315","total",198,44,242,"14 June 1926","27"
"319","Radikal-demokratische Fraktion (R)",59,22,81,"16 December 1926","27"
"320","Katholisch-Konservative Fraktion (K)",42,17,59,"16 December 1926","27"
"321","Sozialdemokratische Fraktion (S)",49,2,51,"16 December 1926","27"
"322","Bauern-, Gewerbe- und Bürgerfraktion (B)",30,1,31,"16 December 1926","27"
"323","Liberal-demokratische Fraktion (L)",7,1,8,"16 December 1926","27"
"324","Sozialpolitische Fraktion (SPOL)",5,1,6,"16 December 1926","27"
"325","Kommunistische Fraktion (Ko)",3,0,3,"16 December 1926","27"
"326","ohne Fraktionsangehörigkeit",3,0,3,"16 December 1926","27"
"327","total",198,44,242,"16 December 1926","27"
"331","Radikal-demokratische Fraktion (R)",59,21,80,"17 June 1927","27"
"332","Katholisch-Konservative Fraktion (K)",42,18,60,"17 June 1927","27"
"333","Sozialdemokratische Fraktion (S)",49,2,51,"17 June 1927","27"
"334","Bauern-, Gewerbe- und Bürgerfraktion (B)",30,1,31,"17 June 1927","27"
"335","Liberal-demokratische Fraktion (L)",7,1,8,"17 June 1927","27"
"336","Sozialpolitische Fraktion (SPOL)",5,1,6,"17 June 1927","27"
"337","Kommunistische Fraktion (Ko)",3,0,3,"17 June 1927","27"
"338","ohne Fraktionsangehörigkeit",3,0,3,"17 June 1927","27"
"339","total",198,44,242,"17 June 1927","27"
"343","Radikal-demokratische Fraktion (R)",59,21,80,"23 December 1927","27"
"344","Katholisch-Konservative Fraktion (K)",42,18,60,"23 December 1927","27"
"345","Sozialdemokratische Fraktion (S)",49,2,51,"23 December 1927","27"
"346","Bauern-, Gewerbe- und Bürgerfraktion (B)",30,1,31,"23 December 1927","27"
"347","Liberal-demokratische Fraktion (L)",7,1,8,"23 December 1927","27"
"348","Sozialpolitische Fraktion (SPOL)",5,1,6,"23 December 1927","27"
"349","Kommunistische Fraktion (Ko)",3,0,3,"23 December 1927","27"
"350","ohne Fraktionsangehörigkeit",3,0,3,"23 December 1927","27"
"351","total",198,44,242,"23 December 1927","27"
"355","Radikal-demokratische Fraktion (R)",59,20,79,"11 June 1928","27"
"356","Katholisch-Konservative Fraktion (K)",42,18,60,"11 June 1928","27"
"357","Sozialdemokratische Fraktion (S)",49,2,51,"11 June 1928","27"
"358","Bauern-, Gewerbe- und Bürgerfraktion (B)",31,2,33,"11 June 1928","27"
"359","Liberal-demokratische Fraktion (L)",7,1,8,"11 June 1928","27"
"360","Sozialpolitische Fraktion (SPOL)",5,1,6,"11 June 1928","27"
"361","Kommunistische Fraktion (Ko)",3,0,3,"11 June 1928","27"
"362","ohne Fraktionsangehörigkeit",2,0,2,"11 June 1928","27"
"363","total",198,44,242,"11 June 1928","27"
"367","Radikal-demokratische Fraktion (R)",58,20,78,"20 December 1928","28"
"368","Katholisch-Konservative Fraktion (K)",46,18,64,"20 December 1928","28"
"369","Sozialdemokratische Fraktion (S)",50,0,50,"20 December 1928","28"
"370","Bauern-, Gewerbe- und Bürgerfraktion (B)",31,3,34,"20 December 1928","28"
"371","Liberal-demokratische Fraktion (L)",6,1,7,"20 December 1928","28"
"372","Sozialpolitische Fraktion (SPOL)",3,1,4,"20 December 1928","28"
"373","ohne Fraktionsangehörigkeit",4,1,5,"20 December 1928","28"
"374","total",198,44,242,"20 December 1928","28"
"378","Radikal-demokratische Fraktion (R)",58,20,78,"21 June 1929","28"
"379","Katholisch-Konservative Fraktion (K)",46,18,64,"21 June 1929","28"
"380","Sozialdemokratische Fraktion (S)",50,0,50,"21 June 1929","28"
"381","Bauern-, Gewerbe- und Bürgerfraktion (B)",31,3,34,"21 June 1929","28"
"382","Liberal-demokratische Fraktion (L)",6,1,7,"21 June 1929","28"
"383","Sozialpolitische Fraktion (SPOL)",3,1,4,"21 June 1929","28"
"384","ohne Fraktionsangehörigkeit",4,1,5,"21 June 1929","28"
"385","total",198,44,242,"21 June 1929","28"
"389","Radikal-demokratische Fraktion (R)",58,20,78,"10 January 1930","28"
"390","Katholisch-Konservative Fraktion (K)",46,18,64,"10 January 1930","28"
"391","Sozialdemokratische Fraktion (S)",50,0,50,"10 January 1930","28"
"392","Bauern-, Gewerbe- und Bürgerfraktion (B)",31,3,34,"10 January 1930","28"
"393","Liberal-demokratische Fraktion (L)",6,1,7,"10 January 1930","28"
"394","Sozialpolitische Fraktion (SPOL)",3,1,4,"10 January 1930","28"
"395","ohne Fraktionsangehörigkeit",4,1,5,"10 January 1930","28"
"396","total",198,44,242,"10 January 1930","28"
"400","Radikal-demokratische Fraktion (R)",58,20,78,"18 June 1930","28"
"401","Katholisch-Konservative Fraktion (K)",46,17,63,"18 June 1930","28"
"402","Sozialdemokratische Fraktion (S)",50,0,50,"18 June 1930","28"
"403","Bauern-, Gewerbe- und Bürgerfraktion (B)",31,3,34,"18 June 1930","28"
"404","Liberal-demokratische Fraktion (L)",6,1,7,"18 June 1930","28"
"405","Sozialpolitische Fraktion (SPOL)",3,1,4,"18 June 1930","28"
"406","ohne Fraktionsangehörigkeit",4,1,5,"18 June 1930","28"
"407","nicht besetzte Sitze",0,1,1,"18 June 1930","28"
"408","total",198,44,242,"18 June 1930","28"
"412","Radikal-demokratische Fraktion (R)",58,19,77,"27 December 1930","28"
"413","Katholisch-Konservative Fraktion (K)",46,18,64,"27 December 1930","28"
"414","Sozialdemokratische Fraktion (S)",50,1,51,"27 December 1930","28"
"415","Bauern-, Gewerbe- und Bürgerfraktion (B)",31,3,34,"27 December 1930","28"
"416","Liberal-demokratische Fraktion (L)",6,1,7,"27 December 1930","28"
"417","Sozialpolitische Fraktion (SPOL)",3,1,4,"27 December 1930","28"
"418","ohne Fraktionsangehörigkeit",4,1,5,"27 December 1930","28"
"419","nicht besetzte Sitze",0,0,0,"27 December 1930","28"
"420","total",198,44,242,"27 December 1930","28"
"424","Radikal-demokratische Fraktion (R)",58,19,77,"19 June 1931","28"
"425","Katholisch-Konservative Fraktion (K)",46,18,64,"19 June 1931","28"
"426","Sozialdemokratische Fraktion (S)",50,1,51,"19 June 1931","28"
"427","Bauern-, Gewerbe- und Bürgerfraktion (B)",31,3,34,"19 June 1931","28"
"428","Liberal-demokratische Fraktion (L)",6,1,7,"19 June 1931","28"
"429","Sozialpolitische Fraktion (SPOL)",3,1,4,"19 June 1931","28"
"430","ohne Fraktionsangehörigkeit",4,1,5,"19 June 1931","28"
"431","total",198,44,242,"19 June 1931","28"
"435","Radikal-demokratische Fraktion (R)",52,19,71,"23 December 1931","29"
"436","Katholisch-Konservative Fraktion (K)",44,18,62,"23 December 1931","29"
"437","Sozialdemokratische Fraktion (S)",49,2,51,"23 December 1931","29"
"438","Bauern-, Gewerbe- und Bürgerfraktion (B)",30,3,33,"23 December 1931","29"
"439","Liberal-demokratische Fraktion (L)",6,1,7,"23 December 1931","29"
"440","Sozialpolitische Fraktion (SPOL)",0,0,0,"23 December 1931","29"
"441","ohne Fraktionsangehörigkeit",6,1,7,"23 December 1931","29"
"442","total",187,44,231,"23 December 1931","29"
"446","Radikal-demokratische Fraktion (R)",52,18,70,"16 June 1932","29"
"447","Katholisch-Konservative Fraktion (K)",44,18,62,"16 June 1932","29"
"448","Sozialdemokratische Fraktion (S)",49,2,51,"16 June 1932","29"
"449","Bauern-, Gewerbe- und Bürgerfraktion (B)",30,3,33,"16 June 1932","29"
"450","Liberal-demokratische Fraktion (L)",6,1,7,"16 June 1932","29"
"451","ohne Fraktionsangehörigkeit",6,1,7,"16 June 1932","29"
"452","nicht besetzte Sitze",0,1,1,"16 June 1932","29"
"453","total",187,44,231,"16 June 1932","29"
"457","Radikal-demokratische Fraktion (R)",52,18,70,"22 December 1932","29"
"458","Katholisch-Konservative Fraktion (K)",44,18,62,"22 December 1932","29"
"459","Sozialdemokratische Fraktion (S)",49,2,51,"22 December 1932","29"
"460","Bauern-, Gewerbe- und Bürgerfraktion (B)",30,3,33,"22 December 1932","29"
"461","Liberal-demokratische Fraktion (L)",6,1,7,"22 December 1932","29"
"462","ohne Fraktionsangehörigkeit",6,1,7,"22 December 1932","29"
"463","nicht besetzte Sitze",0,1,1,"22 December 1932","29"
"464","total",187,44,231,"22 December 1932","29"
"468","Radikal-demokratische Fraktion (R)",52,18,70,"15 June 1933","29"
"469","Katholisch-Konservative Fraktion (K)",43,19,62,"15 June 1933","29"
"470","Sozialdemokratische Fraktion (S)",49,1,50,"15 June 1933","29"
"471","Bauern-, Gewerbe- und Bürgerfraktion (B)",30,3,33,"15 June 1933","29"
"472","Liberal-demokratische Fraktion (L)",6,2,8,"15 June 1933","29"
"473","ohne Fraktionsangehörigkeit",6,1,7,"15 June 1933","29"
"474","nicht besetzte Sitze",1,1,2,"15 June 1933","29"
"475","total",187,45,232,"15 June 1933","29"
"479","Radikal-demokratische Fraktion (R)",52,18,70,"22 December 1933","29"
"480","Katholisch-Konservative Fraktion (K)",44,19,63,"22 December 1933","29"
"481","Sozialdemokratische Fraktion (S)",48,1,49,"22 December 1933","29"
"482","Bauern-, Gewerbe- und Bürgerfraktion (B)",30,3,33,"22 December 1933","29"
"483","Liberal-demokratische Fraktion (L)",6,2,8,"22 December 1933","29"
"484","ohne Fraktionsangehörigkeit",6,1,7,"22 December 1933","29"
"485","nicht besetzte Sitze",1,0,1,"22 December 1933","29"
"486","total",187,44,231,"22 December 1933","29"
"490","Radikal-demokratische Fraktion (R)",52,17,69,"18 June 1934","29"
"491","Katholisch-Konservative Fraktion (K)",44,19,63,"18 June 1934","29"
"492","Sozialdemokratische Fraktion (S)",49,1,50,"18 June 1934","29"
"493","Bauern-, Gewerbe- und Bürgerfraktion (B)",30,3,33,"18 June 1934","29"
"494","Liberal-demokratische Fraktion (L)",6,2,8,"18 June 1934","29"
"495","ohne Fraktionsangehörigkeit",6,1,7,"18 June 1934","29"
"496","nicht besetzte Sitze",0,1,1,"18 June 1934","29"
"497","total",187,44,231,"18 June 1934","29"
"501","Radikal-demokratische Fraktion (R)",52,17,69,"19 December 1934","29"
"502","Katholisch-Konservative Fraktion (K)",44,19,63,"19 December 1934","29"
"503","Sozialdemokratische Fraktion (S)",49,1,50,"19 December 1934","29"
"504","Bauern-, Gewerbe- und Bürgerfraktion (B)",30,3,33,"19 December 1934","29"
"505","Liberal-demokratische Fraktion (L)",6,2,8,"19 December 1934","29"
"506","ohne Fraktionsangehörigkeit",6,2,8,"19 December 1934","29"
"507","nicht besetzte Sitze",0,0,0,"19 December 1934","29"
"508","total",187,44,231,"19 December 1934","29"
"512","Radikal-demokratische Fraktion (R)",52,16,68,"14 June 1935","29"
"513","Katholisch-Konservative Fraktion (K)",43,19,62,"14 June 1935","29"
"514","Sozialdemokratische Fraktion (S)",49,1,50,"14 June 1935","29"
"515","Bauern-, Gewerbe- und Bürgerfraktion (B)",28,3,31,"14 June 1935","29"
"516","Liberal-demokratische Fraktion (L)",6,2,8,"14 June 1935","29"
"517","ohne Fraktionszugehörigkeit (inkl. ""junge Bauern"")",8,3,11,"14 June 1935","29"
"518","nicht besetzte Sitze",1,0,1,"14 June 1935","29"
"519","total",187,44,231,"14 June 1935","29"
"523","Radikal-demokratische Fraktion (R)",48,15,63,"11 December 1935","30"
"524","Katholisch-Konservative Fraktion (K)",42,19,61,"11 December 1935","30"
"525","Sozialdemokratische Fraktion (S)",50,3,53,"11 December 1935","30"
"526","Bauern-, Gewerbe- und Bürgerfraktion (B)",21,3,24,"11 December 1935","30"
"527","Liberal-demokratische Fraktion (L)",7,2,9,"11 December 1935","30"
"528","Freie und demokratische Fraktion (DEM)",7,0,7,"11 December 1935","30"
"529","unabhängige Fraktion (U)",7,0,7,"11 December 1935","30"
"530","ohne Fraktionszugehörigkeit",5,2,7,"11 December 1935","30"
"531","total",187,44,231,"11 December 1935","30"
"535","Radikal-demokratische Fraktion (R)",48,15,63,"12 June 1936","30"
"536","Katholisch-Konservative Fraktion (K) ",42,18,60,"12 June 1936","30"
"537","Sozialdemokratische Fraktion (S)",50,3,53,"12 June 1936","30"
"538","Bauern-, Gewerbe- und Bürgerfraktion (B)",21,3,24,"12 June 1936","30"
"539","Liberal-demokratische Fraktion (L)",7,2,9,"12 June 1936","30"
"540","Freie und demokratische Fraktion (DEM)",7,0,7,"12 June 1936","30"
"541","unabhängige Fraktion (U)",7,0,7,"12 June 1936","30"
"542","ohne Fraktionszugehörigkeit",5,2,7,"12 June 1936","30"
"543","nicht besetzte Sitze",0,1,1,"12 June 1936","30"
"544","total",187,44,231,"12 June 1936","30"
"548","Radikal-demokratische Fraktion (R)",48,15,63,"17 December 1936","30"
"549","Katholisch-Konservative Fraktion (K)",42,18,60,"17 December 1936","30"
"550","Sozialdemokratische Fraktion (S)",50,3,53,"17 December 1936","30"
"551","Bauern-, Gewerbe- und Bürgerfraktion (B)",21,3,24,"17 December 1936","30"
"552","Liberal-demokratische Fraktion (L)",7,2,9,"17 December 1936","30"
"553","Freie und demokratische Fraktion (DEM)",7,0,7,"17 December 1936","30"
"554","unabhängige Fraktion (U)",7,0,7,"17 December 1936","30"
"555","ohne Fraktionszugehörigkeit",5,3,8,"17 December 1936","30"
"556","total",187,44,231,"17 December 1936","30"
"560","Radikal-demokratische Fraktion (R)",48,15,63,"30 June 1937","30"
"561","Katholisch-Konservative Fraktion (K)",42,18,60,"30 June 1937","30"
"562","Sozialdemokratische Fraktion (S)",50,3,53,"30 June 1937","30"
"563","Bauern-, Gewerbe- und Bürgerfraktion (B)",21,3,24,"30 June 1937","30"
"564","Liberal-demokratische Fraktion (L)",7,2,9,"30 June 1937","30"
"565","Freie und demokratische Fraktion (DEM)",7,0,7,"30 June 1937","30"
"566","unabhängige Fraktion (U)",7,0,7,"30 June 1937","30"
"567","ohne Fraktionszugehörigkeit",5,3,8,"30 June 1937","30"
"568","total",187,44,231,"30 June 1937","30"
"572","Radikal-demokratische Fraktion (R)",48,15,63,"23 December 1937","30"
"573","Katholisch-Konservative Fraktion (K)",42,18,60,"23 December 1937","30"
"574","Sozialdemokratische Fraktion (S)",50,3,53,"23 December 1937","30"
"575","Bauern-, Gewerbe- und Bürgerfraktion (B)",21,3,24,"23 December 1937","30"
"576","Liberal-demokratische Fraktion (L)",7,2,9,"23 December 1937","30"
"577","Freie und demokratische Fraktion (DEM)",7,0,7,"23 December 1937","30"
"578","unabhängige Fraktion (U)",7,0,7,"23 December 1937","30"
"579","ohne Fraktionszugehörigkeit",5,3,8,"23 December 1937","30"
"580","total",187,44,231,"23 December 1937","30"
"584","Radikal-demokratische Fraktion (R)",48,15,63,"21 June 1938","30"
"585","Katholisch-Konservative Fraktion (K)",42,18,60,"21 June 1938","30"
"586","Sozialdemokratische Fraktion (S)",50,3,53,"21 June 1938","30"
"587","Bauern-, Gewerbe- und Bürgerfraktion (B)",21,3,24,"21 June 1938","30"
"588","Liberal-demokratische Fraktion (L)",7,2,9,"21 June 1938","30"
"589","Freie und demokratische Fraktion (DEM)",7,0,7,"21 June 1938","30"
"590","unabhängige Fraktion (U)",7,0,7,"21 June 1938","30"
"591","ohne Fraktionszugehörigkeit",5,3,8,"21 June 1938","30"
"592","total",187,44,231,"21 June 1938","30"
"596","Radikal-demokratische Fraktion (R)",48,15,63,"31 December 1938","30"
"597","Katholisch-Konservative Fraktion (K)",42,18,60,"31 December 1938","30"
"598","Sozialdemokratische Fraktion (S)",50,3,53,"31 December 1938","30"
"599","Bauern-, Gewerbe- und Bürgerfraktion (B)",21,3,24,"31 December 1938","30"
"600","Liberal-demokratische Fraktion (L)",7,2,9,"31 December 1938","30"
"601","Freie und demokratische Fraktion (DEM)",7,0,7,"31 December 1938","30"
"602","unabhängige Fraktion (U)",7,0,7,"31 December 1938","30"
"603","ohne Fraktionszugehörigkeit",5,3,8,"31 December 1938","30"
"604","total",187,44,231,"31 December 1938","30"
"608","Radikal-demokratische Fraktion (R)",48,15,63,"30 June 1939","30"
"609","Katholisch-Konservative Fraktion (K)",42,18,60,"30 June 1939","30"
"610","Sozialdemokratische Fraktion (S)",50,3,53,"30 June 1939","30"
"611","Bauern-, Gewerbe- und Bürgerfraktion (B)",21,3,24,"30 June 1939","30"
"612","Liberal-demokratische Fraktion (L)",7,2,9,"30 June 1939","30"
"613","Freie und demokratische Fraktion (DEM)",7,0,7,"30 June 1939","30"
"614","unabhängige Fraktion (U)",7,0,7,"30 June 1939","30"
"615","ohne Fraktionszugehörigkeit",5,3,8,"30 June 1939","30"
"616","total",187,44,231,"30 June 1939","30"
"620","Radikal-demokratische Fraktion (R)",51,14,65,"27 December 1939","31"
"621","Katholisch-Konservative Fraktion (K)",43,18,61,"27 December 1939","31"
"622","Sozialdemokratische Fraktion (S)",45,3,48,"27 December 1939","31"
"623","Bauern-, Gewerbe- und Bürgerfraktion (B)",22,4,26,"27 December 1939","31"
"624","Liberal-demokratische Fraktion (L)",6,2,8,"27 December 1939","31"
"625","Freie und demokratische Fraktion (DEM)",6,0,6,"27 December 1939","31"
"626","unabhängige Fraktion (U)",9,0,9,"27 December 1939","31"
"627","ohne Fraktionszugehörigkeit",5,3,8,"27 December 1939","31"
"628","total",187,44,231,"27 December 1939","31"
"632","Radikal-demokratische Fraktion (R)",51,14,65,"30 June 1940","31"
"633","Katholisch-Konservative Fraktion (K)",43,18,61,"30 June 1940","31"
"634","Sozialdemokratische Fraktion (S)",45,3,48,"30 June 1940","31"
"635","Bauern-, Gewerbe- und Bürgerfraktion (B)",22,4,26,"30 June 1940","31"
"636","Liberal-demokratische Fraktion (L)",6,2,8,"30 June 1940","31"
"637","Freie und demokratische Fraktion (DEM)",6,1,7,"30 June 1940","31"
"638","unabhängige Fraktion (U)",9,0,9,"30 June 1940","31"
"639","ohne Fraktionszugehörigkeit",5,2,7,"30 June 1940","31"
"640","total",187,44,231,"30 June 1940","31"
"644","Radikal-demokratische Fraktion (R)",51,14,65,"30 June 1941","31"
"645","Katholisch-Konservative Fraktion (K)",43,18,61,"30 June 1941","31"
"646","Sozialdemokratische Fraktion (S)",45,3,48,"30 June 1941","31"
"647","Bauern-, Gewerbe- und Bürgerfraktion (B)",22,4,26,"30 June 1941","31"
"648","Liberal-demokratische Fraktion (L)",6,2,8,"30 June 1941","31"
"649","unabhängige Fraktion (U)",9,0,9,"30 June 1941","31"
"650","ohne Fraktionszugehörigkeit",11,3,14,"30 June 1941","31"
"651","total",187,44,231,"30 June 1941","31"
"655","Radikal-demokratische Fraktion (R)",50,14,64,"31 December 1941","31"
"656","Katholisch-Konservative Fraktion (K)",43,18,61,"31 December 1941","31"
"657","Sozialdemokratische Fraktion (S)",45,3,48,"31 December 1941","31"
"658","Bauern-, Gewerbe- und Bürgerfraktion (B)",22,4,26,"31 December 1941","31"
"659","Liberal-demokratische Fraktion (L)",7,2,9,"31 December 1941","31"
"660","Freie und demokratische Fraktion (DEM)",6,2,8,"31 December 1941","31"
"661","unabhängige Fraktion (U)",10,0,10,"31 December 1941","31"
"662","ohne Fraktionszugehörigkeit",4,1,5,"31 December 1941","31"
"663","total",187,44,231,"31 December 1941","31"
"667","Radikal-demokratische Fraktion (R)",49,14,63,"30 June 1942","31"
"668","Katholisch-Konservative Fraktion (K)",43,18,61,"30 June 1942","31"
"669","Sozialdemokratische Fraktion (S)",45,3,48,"30 June 1942","31"
"670","Bauern-, Gewerbe- und Bürgerfraktion (B)",22,4,26,"30 June 1942","31"
"671","Liberal-demokratische Fraktion (L)",8,2,10,"30 June 1942","31"
"672","Demokratische Fraktion (D)",6,2,8,"30 June 1942","31"
"673","unabhängige Fraktion (U)",10,0,10,"30 June 1942","31"
"674","ohne Fraktionszugehörigkeit",4,1,5,"30 June 1942","31"
"675","total",187,44,231,"30 June 1942","31"
"679","Radikal-demokratische Fraktion (R)",49,14,63,"31 December 1942","31"
"680","Katholisch-Konservative Fraktion (K)",43,18,61,"31 December 1942","31"
"681","Sozialdemokratische Fraktion (S)",45,3,48,"31 December 1942","31"
"682","Bauern-, Gewerbe- und Bürgerfraktion (B)",22,4,26,"31 December 1942","31"
"683","Liberal-demokratische Fraktion (L)",8,2,10,"31 December 1942","31"
"684","Demokratische Fraktion (D)",6,2,8,"31 December 1942","31"
"685","unabhängige Fraktion (U)",10,0,10,"31 December 1942","31"
"686","ohne Fraktionszugehörigkeit",4,3,7,"31 December 1942","31"
"687","total",187,46,233,"31 December 1942","31"
"691","Radikal-demokratische Fraktion (R)",49,14,63,"30 June 1943","31"
"692","Katholisch-Konservative Fraktion (K)",43,19,62,"30 June 1943","31"
"693","Sozialdemokratische Fraktion (S)",45,3,48,"30 June 1943","31"
"694","Bauern-, Gewerbe- und Bürgerfraktion (B)",22,4,26,"30 June 1943","31"
"695","Liberal-demokratische Fraktion (L)",8,2,10,"30 June 1943","31"
"696","Demokratische Fraktion (D)",6,2,8,"30 June 1943","31"
"697","unabhängige Fraktion (U)",10,0,10,"30 June 1943","31"
"698","ohne Fraktionszugehörigkeit",4,0,4,"30 June 1943","31"
"699","total",187,44,231,"30 June 1943","31"
"703","Radikal-demokratische Fraktion (R)",47,12,59,"1 January 1944","32"
"704","Katholisch-Konservative Fraktion (K)",43,19,62,"1 January 1944","32"
"705","Sozialdemokratische Fraktion (S)",56,5,61,"1 January 1944","32"
"706","Bauern-, Gewerbe- und Bürgerfraktion (B)",22,4,26,"1 January 1944","32"
"707","Liberal-demokratische Fraktion (L)",8,2,10,"1 January 1944","32"
"708","Demokratische Fraktion (D)",6,2,8,"1 January 1944","32"
"709","Fraktion des Landesrings (U)",5,0,5,"1 January 1944","32"
"710","ohne Fraktionszugehörigkeit",7,0,7,"1 January 1944","32"
"711","total",194,44,238,"1 January 1944","32"
"715","Radikal-demokratische Fraktion (R)",47,12,59,"1 July 1944","32"
"716","Katholisch-Konservative Fraktion (K)",43,19,62,"1 July 1944","32"
"717","Sozialdemokratische Fraktion (S)",54,5,59,"1 July 1944","32"
"718","Bauern-, Gewerbe- und Bürgerfraktion (B)",22,4,26,"1 July 1944","32"
"719","Liberal-demokratische Fraktion (L)",8,2,10,"1 July 1944","32"
"720","Demokratische Fraktion (D)",6,2,8,"1 July 1944","32"
"721","Fraktion des Landesrings (U)",5,0,5,"1 July 1944","32"
"722","ohne Fraktionszugehörigkeit",9,0,9,"1 July 1944","32"
"723","total",194,44,238,"1 July 1944","32"
"727","Radikal-demokratische Fraktion (R)",47,12,59,"1 January 1945","32"
"728","Katholisch-Konservative Fraktion (K)",43,19,62,"1 January 1945","32"
"729","Sozialdemokratische Fraktion (S)",54,5,59,"1 January 1945","32"
"730","Bauern-, Gewerbe- und Bürgerfraktion (B)",22,4,26,"1 January 1945","32"
"731","Liberal-demokratische Fraktion (L)",8,2,10,"1 January 1945","32"
"732","Demokratische Fraktion (D)",6,2,8,"1 January 1945","32"
"733","Fraktion des Landesrings (U)",5,0,5,"1 January 1945","32"
"734","ohne Fraktionszugehörigkeit",9,0,9,"1 January 1945","32"
"735","total",194,44,238,"1 January 1945","32"
"739","Radikal-demokratische Fraktion (R)",47,11,58,"1 July 1945","32"
"740","Katholisch-Konservative Fraktion (K)",43,19,62,"1 July 1945","32"
"741","Sozialdemokratische Fraktion (S)",54,6,60,"1 July 1945","32"
"742","Bauern-, Gewerbe- und Bürgerfraktion (B)",22,4,26,"1 July 1945","32"
"743","Liberal-demokratische Fraktion (L)",8,2,10,"1 July 1945","32"
"744","Demokratische Fraktion (D)",6,2,8,"1 July 1945","32"
"745","Fraktion des Landesrings (U)",5,0,5,"1 July 1945","32"
"746","ohne Fraktionszugehörigkeit",9,0,9,"1 July 1945","32"
"747","total",194,44,238,"1 July 1945","32"
"751","Radikal-demokratische Fraktion (R)",47,11,58,"1 January 1946","32"
"752","Katholisch-Konservative Fraktion (K)",43,19,62,"1 January 1946","32"
"753","Sozialdemokratische Fraktion (S)",54,6,60,"1 January 1946","32"
"754","Bauern-, Gewerbe- und Bürgerfraktion (B)",22,4,26,"1 January 1946","32"
"755","Liberal-demokratische Fraktion (L)",8,2,10,"1 January 1946","32"
"756","Demokratische Fraktion (D)",6,2,8,"1 January 1946","32"
"757","Fraktion des Landesrings (U)",5,0,5,"1 January 1946","32"
"758","ohne Fraktionszugehörigkeit",9,0,9,"1 January 1946","32"
"759","total",194,44,238,"1 January 1946","32"
"763","Radikal-demokratische Fraktion (R)",47,9,56,"1 July 1946","32"
"764","Katholisch-Konservative Fraktion (K)",43,19,62,"1 July 1946","32"
"765","Sozialdemokratische Fraktion (S)",54,6,60,"1 July 1946","32"
"766","Bauern-, Gewerbe- und Bürgerfraktion (B)",22,4,26,"1 July 1946","32"
"767","Liberal-demokratische Fraktion (L)",8,2,10,"1 July 1946","32"
"768","Demokratische Fraktion (D)",6,2,8,"1 July 1946","32"
"769","Fraktion des Landesrings (U)",6,0,6,"1 July 1946","32"
"770","ohne Fraktionszugehörigkeit",8,1,9,"1 July 1946","32"
"771",NA,0,1,1,"1 July 1946","32"
"772","total",194,44,238,"1 July 1946","32"
"776","Radikal-demokratische Fraktion (R)",47,10,57,"1 January 1947","32"
"777","Katholisch-Konservative Fraktion (K)",43,18,61,"1 January 1947","32"
"778","Sozialdemokratische Fraktion (S)",54,6,60,"1 January 1947","32"
"779","Bauern-, Gewerbe- und Bürgerfraktion (B)",22,4,26,"1 January 1947","32"
"780","Liberal-demokratische Fraktion (L)",8,2,10,"1 January 1947","32"
"781","Demokratische Fraktion (D)",6,2,8,"1 January 1947","32"
"782","Fraktion des Landesrings (U)",6,0,6,"1 January 1947","32"
"783","ohne Fraktionszugehörigkeit",8,1,9,"1 January 1947","32"
"784",NA,0,1,0,"1 January 1947","32"
"785","total",194,44,238,"1 January 1947","32"
"789","Radikal-demokratische Fraktion (R)",47,10,57,"1-Jul-47","32"
"790","Katholisch-Konservative Fraktion (K)",43,18,61,"1-Jul-47","32"
"791","Sozialdemokratische Fraktion (S)",55,6,61,"1-Jul-47","32"
"792","Bauern-, Gewerbe- und Bürgerfraktion (B)",22,4,26,"1-Jul-47","32"
"793","Liberal-demokratische Fraktion (L)",8,2,10,"1-Jul-47","32"
"794","Demokratische Fraktion (D)",6,2,8,"1-Jul-47","32"
"795","Fraktion des Landesrings (U)",6,0,6,"1-Jul-47","32"
"796","ohne Fraktionszugehörigkeit",7,2,9,"1-Jul-47","32"
"797","total",194,44,238,"1-Jul-47","32"
"801","Radikal-demokratische Fraktion (R)",52,11,63,"1 January 1948","33"
"802","Katholisch-Konservative Fraktion (K)",44,18,62,"1 January 1948","33"
"803","Sozialdemokratische Fraktion (S)",48,5,53,"1 January 1948","33"
"804","Bauern-, Gewerbe- und Bürgerfraktion (B)",21,4,25,"1 January 1948","33"
"805","Liberal-demokratische Fraktion (L)",7,2,9,"1 January 1948","33"
"806","Demokratische Fraktion (D)",5,2,7,"1 January 1948","33"
"807","Fraktion des Landesrings (U)",9,0,9,"1 January 1948","33"
"808","Fraktion der Partei der Arbeit (T)",7,0,7,"1 January 1948","33"
"809","ohne Fraktionszugehörigkeit",1,2,3,"1 January 1948","33"
"810","total",194,44,238,"1 January 1948","33"
"814","Radikal-demokratische Fraktion (R)",52,11,63,"1 July 1948","33"
"815","Katholisch-Konservative Fraktion (K)",44,18,62,"1 July 1948","33"
"816","Sozialdemokratische Fraktion (S)",48,5,53,"1 July 1948","33"
"817","Bauern-, Gewerbe- und Bürgerfraktion (B)",21,4,25,"1 July 1948","33"
"818","Liberal-demokratische Fraktion (L)",7,2,9,"1 July 1948","33"
"819","Demokratische Fraktion (D)",5,2,7,"1 July 1948","33"
"820","Fraktion des Landesrings (U)",9,0,9,"1 July 1948","33"
"821","Fraktion der Partei der Arbeit (T)",7,0,7,"1 July 1948","33"
"822","ohne Fraktionszugehörigkeit",1,2,3,"1 July 1948","33"
"823","total",194,44,238,"1 July 1948","33"
"827","Radikal-demokratische Fraktion (R)",52,11,63,"1 January 1949","33"
"828","Katholisch-Konservative Fraktion (K)",44,18,62,"1 January 1949","33"
"829","Sozialdemokratische Fraktion (S)",48,5,53,"1 January 1949","33"
"830","Bauern-, Gewerbe- und Bürgerfraktion (B)",21,4,25,"1 January 1949","33"
"831","Liberal-demokratische Fraktion (L)",7,2,9,"1 January 1949","33"
"832","Demokratische Fraktion (D)",5,2,7,"1 January 1949","33"
"833","Fraktion des Landesrings (U)",9,0,9,"1 January 1949","33"
"834","Fraktion der Partei der Arbeit (T)",7,0,7,"1 January 1949","33"
"835","ohne Fraktionszugehörigkeit",1,2,3,"1 January 1949","33"
"836","total",194,44,238,"1 January 1949","33"
"840","Radikal-demokratische Fraktion (R)",52,11,63,"1 July 1949","33"
"841","Katholisch-Konservative Fraktion (K)",44,18,62,"1 July 1949","33"
"842","Sozialdemokratische Fraktion (S)",48,4,52,"1 July 1949","33"
"843","Bauern-, Gewerbe- und Bürgerfraktion (B)",21,3,24,"1 July 1949","33"
"844","Liberal-demokratische Fraktion (L)",7,3,10,"1 July 1949","33"
"845","Demokratische Fraktion (D)",5,2,7,"1 July 1949","33"
"846","Fraktion des Landesrings (U)",9,0,9,"1 July 1949","33"
"847","Fraktion der Partei der Arbeit (T)",7,0,7,"1 July 1949","33"
"848","ohne Fraktionszugehörigkeit",1,2,3,"1 July 1949","33"
"849","nicht besetzte Sitze",0,1,1,"1 July 1949","33"
"850","total",194,44,238,"1 July 1949","33"
"854","Radikal-demokratische Fraktion (R)",52,11,63,"1 January 1950","33"
"855","Katholisch-Konservative Fraktion (K)",44,17,61,"1 January 1950","33"
"856","Sozialdemokratische Fraktion (S)",48,4,52,"1 January 1950","33"
"857","Bauern-, Gewerbe- und Bürgerfraktion (B)",21,3,24,"1 January 1950","33"
"858","Liberal-demokratische Fraktion (L)",7,3,10,"1 January 1950","33"
"859","Demokratische Fraktion (D)",5,2,7,"1 January 1950","33"
"860","Fraktion des Landesrings (U)",9,1,10,"1 January 1950","33"
"861","Fraktion der Partei der Arbeit (T)",7,0,7,"1 January 1950","33"
"862","ohne Fraktionszugehörigkeit",1,2,3,"1 January 1950","33"
"863","nicht besetzte Sitze",0,1,0,"1 January 1950","33"
"864","total",194,44,238,"1 January 1950","33"
"868","Radikal-demokratische Fraktion (R)",52,11,63,"1 July 1950","33"
"869","Katholisch-Konservative Fraktion (K)",44,18,62,"1 July 1950","33"
"870","Sozialdemokratische Fraktion (S)",48,4,52,"1 July 1950","33"
"871","Bauern-, Gewerbe- und Bürgerfraktion (B)",21,3,24,"1 July 1950","33"
"872","Liberal-demokratische Fraktion (L)",7,3,10,"1 July 1950","33"
"873","Demokratische Fraktion (D)",5,2,7,"1 July 1950","33"
"874","Fraktion des Landesrings (U)",9,1,10,"1 July 1950","33"
"875","Fraktion der Partei der Arbeit (T)",6,0,6,"1 July 1950","33"
"876","ohne Fraktionszugehörigkeit",2,2,4,"1 July 1950","33"
"877","total",194,44,238,"1 July 1950","33"
"881","Radikal-demokratische Fraktion (R)",52,11,63,"1 January 1951","33"
"882","Katholisch-Konservative Fraktion (K)",44,18,62,"1 January 1951","33"
"883","Sozialdemokratische Fraktion (S)",48,4,52,"1 January 1951","33"
"884","Bauern-, Gewerbe- und Bürgerfraktion (B)",21,3,24,"1 January 1951","33"
"885","Liberal-demokratische Fraktion (L)",7,3,10,"1 January 1951","33"
"886","Demokratische Fraktion (D)",5,2,7,"1 January 1951","33"
"887","Fraktion des Landesrings (U)",9,1,10,"1 January 1951","33"
"888","Fraktion der Partei der Arbeit (T)",6,0,6,"1 January 1951","33"
"889","ohne Fraktionszugehörigkeit",2,2,4,"1 January 1951","33"
"890","total",194,44,238,"1 January 1951","33"
"894","Radikal-demokratische Fraktion (R)",52,11,63,"1 July 1951","33"
"895","Katholisch-Konservative Fraktion (K)",44,18,62,"1 July 1951","33"
"896","Sozialdemokratische Fraktion (S)",48,5,53,"1 July 1951","33"
"897","Bauern-, Gewerbe- und Bürgerfraktion (B)",21,4,25,"1 July 1951","33"
"898","Liberal-demokratische Fraktion (L)",7,2,9,"1 July 1951","33"
"899","Demokratische Fraktion (D)",5,2,7,"1 July 1951","33"
"900","Fraktion des Landesrings (U)",9,0,9,"1 July 1951","33"
"901","Fraktion der Partei der Arbeit (T)",6,0,6,"1 July 1951","33"
"902","ohne Fraktionszugehörigkeit",2,2,4,"1 July 1951","33"
"903","total",194,44,238,"1 July 1951","33"
"907","Radikal-demokratische Fraktion (R)",51,12,63,"1 January 1952","34"
"908","Katholisch-Konservative Fraktion (K)",48,18,66,"1 January 1952","34"
"909","Sozialdemokratische Fraktion (S)",49,4,53,"1 January 1952","34"
"910","Bauern-, Gewerbe- und Bürgerfraktion (B)",23,3,26,"1 January 1952","34"
"911","Liberal-demokratische Fraktion (L)",5,3,8,"1 January 1952","34"
"912","Demokratische und evangelische Fraktion (D)",5,2,7,"1 January 1952","34"
"913","Fraktion des Landesrings (U)",10,0,10,"1 January 1952","34"
"914","ohne Fraktionszugehörigkeit",5,2,7,"1 January 1952","34"
"915","total",196,44,240,"1 January 1952","34"
"919","Radikal-demokratische Fraktion (R)",51,12,63,"1 July 1952","34"
"920","Katholisch-Konservative Fraktion (K)",48,18,66,"1 July 1952","34"
"921","Sozialdemokratische Fraktion (S)",49,4,53,"1 July 1952","34"
"922","Bauern-, Gewerbe- und Bürgerfraktion (B)",23,3,26,"1 July 1952","34"
"923","Liberal-demokratische Fraktion (L)",5,3,8,"1 July 1952","34"
"924","Demokratische und evangelische Fraktion (D)",5,2,7,"1 July 1952","34"
"925","Fraktion des Landesrings (U)",10,0,10,"1 July 1952","34"
"926","Fraktion der Partei der Arbeit (T)",5,0,5,"1 July 1952","34"
"927","ohne Fraktionszugehörigkeit",0,2,2,"1 July 1952","34"
"928","total",196,44,240,"1 July 1952","34"
"932","Radikal-demokratische Fraktion (R)",51,12,63,"1 January 1953","34"
"933","Katholisch-Konservative Fraktion (K)",48,18,66,"1 January 1953","34"
"934","Sozialdemokratische Fraktion (S)",49,4,53,"1 January 1953","34"
"935","Bauern-, Gewerbe- und Bürgerfraktion (B)",23,3,26,"1 January 1953","34"
"936","Liberal-demokratische Fraktion (L)",5,3,8,"1 January 1953","34"
"937","Demokratische und evangelische Fraktion (D)",5,2,7,"1 January 1953","34"
"938","Fraktion des Landesrings (U)",10,0,10,"1 January 1953","34"
"939","ohne Fraktionszugehörigkeit",5,2,7,"1 January 1953","34"
"940","total",196,44,240,"1 January 1953","34"
"944","Radikal-demokratische Fraktion (R)",51,12,63,"1 July 1953","34"
"945","Katholisch-Konservative Fraktion (K)",48,18,66,"1 July 1953","34"
"946","Sozialdemokratische Fraktion (S)",49,4,53,"1 July 1953","34"
"947","Bauern-, Gewerbe- und Bürgerfraktion (B)",23,3,26,"1 July 1953","34"
"948","Liberal-demokratische Fraktion (L)",5,3,8,"1 July 1953","34"
"949","Demokratische und evangelische Fraktion (D)",5,2,7,"1 July 1953","34"
"950","Fraktion des Landesrings (U)",10,0,10,"1 July 1953","34"
"951","ohne Fraktionszugehörigkeit",5,2,7,"1 July 1953","34"
"952","total",196,44,240,"1 July 1953","34"
"956","Radikal-demokratische Fraktion (R)",51,12,63,"1 January 1954","34"
"957","Katholisch-Konservative Fraktion (K)",48,18,66,"1 January 1954","34"
"958","Sozialdemokratische Fraktion (S)",49,4,53,"1 January 1954","34"
"959","Bauern-, Gewerbe- und Bürgerfraktion (B)",23,3,26,"1 January 1954","34"
"960","Liberal-demokratische Fraktion (L)",5,3,8,"1 January 1954","34"
"961","Demokratische und evangelische Fraktion (D)",5,2,7,"1 January 1954","34"
"962","Fraktion des Landesrings (U)",10,0,10,"1 January 1954","34"
"963","ohne Fraktionszugehörigkeit",5,2,7,"1 January 1954","34"
"964","total",196,44,240,"1 January 1954","34"
"968","Radikal-demokratische Fraktion (R)",51,12,63,"1 January 1955","34"
"969","Katholisch-Konservative Fraktion (K)",48,18,66,"1 January 1955","34"
"970","Sozialdemokratische Fraktion (S)",49,4,53,"1 January 1955","34"
"971","Bauern-, Gewerbe- und Bürgerfraktion (B)",23,3,26,"1 January 1955","34"
"972","Liberal-demokratische Fraktion (L)",5,3,8,"1 January 1955","34"
"973","Demokratische und evangelische Fraktion (D)",5,2,7,"1 January 1955","34"
"974","Fraktion des Landesrings (U)",10,0,10,"1 January 1955","34"
"975","ohne Fraktionszugehörigkeit",5,2,7,"1 January 1955","34"
"976","total",196,44,240,"1 January 1955","34"
"980","Radikal-demokratische Fraktion (R)",50,12,62,"1 January 1956","35"
"981","Katholisch-Konservative Fraktion (K)",47,17,64,"1 January 1956","35"
"982","Sozialdemokratische Fraktion (S)",53,5,58,"1 January 1956","35"
"983","Bauern-, Gewerbe- und Bürgerfraktion (B)",22,3,25,"1 January 1956","35"
"984","Liberal-demokratische Fraktion (L)",5,3,8,"1 January 1956","35"
"985","Demokratische und evangelische Fraktion (D)",5,2,7,"1 January 1956","35"
"986","Fraktion des Landesrings (U)",10,0,10,"1 January 1956","35"
"987","ohne Fraktionszugehörigkeit",4,2,6,"1 January 1956","35"
"988","total",196,44,240,"1 January 1956","35"
"992","Radikal-demokratische Fraktion (R)",50,12,62,"1 January 1957","35"
"993","Katholisch-Konservative Fraktion (K)",47,17,64,"1 January 1957","35"
"994","Sozialdemokratische Fraktion (S)",53,5,58,"1 January 1957","35"
"995","Bauern-, Gewerbe- und Bürgerfraktion (B)",22,3,25,"1 January 1957","35"
"996","Liberal-demokratische Fraktion (L)",5,3,8,"1 January 1957","35"
"997","Demokratische und evangelische Fraktion (D)",5,2,7,"1 January 1957","35"
"998","Fraktion des Landesrings (U)",10,0,10,"1 January 1957","35"
"999","ohne Fraktionszugehörigkeit",4,2,6,"1 January 1957","35"
"1000","total",196,44,240,"1 January 1957","35"
"1004","Radikal-demokratische Fraktion (R)",50,12,62,"1 January 1958","35"
"1005","Konservativ-christlichsoziale Fraktion (K)",47,17,64,"1 January 1958","35"
"1006","Sozialdemokratische Fraktion (S)",53,5,58,"1 January 1958","35"
"1007","Bauern-, Gewerbe- und Bürgerfraktion (B)",22,3,25,"1 January 1958","35"
"1008","Liberal-demokratische Fraktion (L)",5,3,8,"1 January 1958","35"
"1009","Demokratische und evangelische Fraktion (D)",5,2,7,"1 January 1958","35"
"1010","Fraktion des Landesrings (U)",10,0,10,"1 January 1958","35"
"1011","ohne Fraktionszugehörigkeit",4,2,6,"1 January 1958","35"
"1012","total",196,44,240,"1 January 1958","35"
"1016","Radikal-demokratische Fraktion (R)",50,12,62,"1 January 1959","35"
"1017","Konservativ-christlichsoziale Fraktion (K)",47,17,64,"1 January 1959","35"
"1018","Sozialdemokratische Fraktion (S)",53,5,58,"1 January 1959","35"
"1019","Bauern-, Gewerbe- und Bürgerfraktion (B)",22,3,25,"1 January 1959","35"
"1020","Liberal-demokratische Fraktion (L)",5,3,8,"1 January 1959","35"
"1021","Demokratische und evangelische Fraktion (D)",5,2,7,"1 January 1959","35"
"1022","Fraktion des Landesrings (U)",10,0,10,"1 January 1959","35"
"1023","ohne Fraktionszugehörigkeit",4,2,6,"1 January 1959","35"
"1024","total",196,44,240,"1 January 1959","35"
"1028","Radikal-demokratische Fraktion (R)",51,14,65,"1 May 1960","36"
"1029","Konservativ-christlichsoziale Fraktion (K)",47,17,64,"1 May 1960","36"
"1030","Sozialdemokratische Fraktion (S)",51,2,53,"1 May 1960","36"
"1031","Bauern-, Gewerbe- und Bürgerfraktion (B)",23,4,27,"1 May 1960","36"
"1032","Fraktion des Landesrings (U)",10,0,10,"1 May 1960","36"
"1033","Liberal-demokratische Fraktion (L)",5,3,8,"1 May 1960","36"
"1034","Demokratische und evangelische Fraktion (D)",6,1,7,"1 May 1960","36"
"1035","ohne Fraktionszugehörigkeit",3,3,6,"1 May 1960","36"
"1036","total",196,44,240,"1 May 1960","36"
"1040","Radikal-demokratische Fraktion (R)",51,14,65,"1 January 1961","36"
"1041","Konservativ-christlichsoziale Fraktion (K)",47,18,65,"1 January 1961","36"
"1042","Sozialdemokratische Fraktion (S)",51,2,53,"1 January 1961","36"
"1043","Bauern-, Gewerbe- und Bürgerfraktion (B)",23,4,27,"1 January 1961","36"
"1044","Fraktion des Landesrings (U)",10,0,10,"1 January 1961","36"
"1045","Liberal-demokratische Fraktion (L)",5,3,8,"1 January 1961","36"
"1046","Demokratische und evangelische Fraktion (D)",6,1,7,"1 January 1961","36"
"1047","ohne Fraktionszugehörigkeit",3,2,5,"1 January 1961","36"
"1048","total",196,44,240,"1 January 1961","36"
"1052","Radikal-demokratische Fraktion (R)",51,14,65,"1 January 1962","36"
"1053","Konservativ-christlichsoziale Fraktion (K)",47,18,65,"1 January 1962","36"
"1054","Sozialdemokratische Fraktion (S)",51,2,53,"1 January 1962","36"
"1055","Bauern-, Gewerbe- und Bürgerfraktion (B)",23,4,27,"1 January 1962","36"
"1056","Fraktion des Landesrings (U)",10,0,10,"1 January 1962","36"
"1057","Liberal-demokratische Fraktion (L)",5,3,8,"1 January 1962","36"
"1058","Demokratische und evangelische Fraktion (D)",6,1,7,"1 January 1962","36"
"1059","ohne Fraktionszugehörigkeit",3,2,5,"1 January 1962","36"
"1060","total",196,44,240,"1 January 1962","36"
"1064","Radikal-demokratische Fraktion (R)",51,14,65,"1 January 1963","36"
"1065","Konservativ-christlichsoziale Fraktion (K)",47,18,65,"1 January 1963","36"
"1066","Sozialdemokratische Fraktion (S)",51,2,53,"1 January 1963","36"
"1067","Bauern-, Gewerbe- und Bürgerfraktion (B)",23,4,27,"1 January 1963","36"
"1068","Fraktion des Landesrings (U)",10,0,10,"1 January 1963","36"
"1069","Liberal-demokratische Fraktion (L)",5,3,8,"1 January 1963","36"
"1070","Demokratische und evangelische Fraktion (D)",6,3,9,"1 January 1963","36"
"1071","ohne Fraktionszugehörigkeit",3,0,3,"1 January 1963","36"
"1072","total",196,44,240,"1 January 1963","36"
"1076","Konservativ-christlichsoziale Fraktion (K)",48,18,66,"1 January 1964","37"
"1077","Radikal-demokratische Fraktion (R)",51,13,64,"1 January 1964","37"
"1078","Sozialdemokratische Fraktion (S)",53,3,56,"1 January 1964","37"
"1079","Bauern-, Gewerbe- und Bürgerfraktion (B)",22,4,26,"1 January 1964","37"
"1080","Fraktion des Landesrings (U)",10,0,10,"1 January 1964","37"
"1081","Liberal-demokratische Fraktion (L)",6,3,9,"1 January 1964","37"
"1082","Demokratische und evangelische Fraktion (D)",6,3,9,"1 January 1964","37"
"1083","ohne Fraktionszugehörigkeit",4,0,4,"1 January 1964","37"
"1084","total",200,44,244,"1 January 1964","37"
"1088","Konservativ-christlichsoziale Fraktion (K)",48,18,66,"1 January 1965","37"
"1089","Radikal-demokratische Fraktion (R)",51,13,64,"1 January 1965","37"
"1090","Sozialdemokratische Fraktion (S)",53,3,56,"1 January 1965","37"
"1091","Bauern-, Gewerbe- und Bürgerfraktion (B)",22,4,26,"1 January 1965","37"
"1092","Fraktion des Landesrings (U)",10,0,10,"1 January 1965","37"
"1093","Liberal-demokratische Fraktion (L)",6,3,9,"1 January 1965","37"
"1094","Demokratische und evangelische Fraktion (D)",5,3,8,"1 January 1965","37"
"1095","ohne Fraktionszugehörigkeit",5,0,5,"1 January 1965","37"
"1096","total",200,44,244,"1 January 1965","37"
"1100","Konservativ-christlichsoziale Fraktion (K)",48,18,66,"1 January 1966","37"
"1101","Radikal-demokratische Fraktion (R)",51,13,64,"1 January 1966","37"
"1102","Sozialdemokratische Fraktion (S)",53,3,56,"1 January 1966","37"
"1103","Bauern-, Gewerbe- und Bürgerfraktion (B)",22,4,26,"1 January 1966","37"
"1104","Fraktion des Landesrings (U)",10,0,10,"1 January 1966","37"
"1105","Liberal-demokratische Fraktion (L)",6,3,9,"1 January 1966","37"
"1106","Demokratische und evangelische Fraktion (D)",5,3,8,"1 January 1966","37"
"1107","ohne Fraktionszugehörigkeit",5,0,5,"1 January 1966","37"
"1108","total",200,44,244,"1 January 1966","37"
"1112","Konservativ-christlichsoziale Fraktion (K)",48,18,66,"1 January 1967","37"
"1113","Radikal-demokratische Fraktion (R)",51,13,64,"1 January 1967","37"
"1114","Sozialdemokratische Fraktion (S)",53,3,56,"1 January 1967","37"
"1115","Bauern-, Gewerbe- und Bürgerfraktion (B)",22,4,26,"1 January 1967","37"
"1116","Fraktion des Landesrings (U)",10,0,10,"1 January 1967","37"
"1117","Liberal-demokratische Fraktion (L)",6,3,9,"1 January 1967","37"
"1118","Demokratische und evangelische Fraktion (D)",5,3,8,"1 January 1967","37"
"1119","ohne Fraktionszugehörigkeit",5,0,5,"1 January 1967","37"
"1120","total",200,44,244,"1 January 1967","37"
"1124","Konservativ-christlichsoziale Fraktion (K)",45,18,63,"1 January 1968","38"
"1125","Radikal-demokratische Fraktion (R)",49,14,63,"1 January 1968","38"
"1126","Sozialdemokratische Fraktion (S)",51,2,53,"1 January 1968","38"
"1127","Bauern-, Gewerbe- und Bürgerfraktion (B)",21,3,24,"1 January 1968","38"
"1128","Fraktion des Landesrings (U)",16,1,17,"1 January 1968","38"
"1129","Liberal-demokratische Fraktion (L)",6,3,9,"1 January 1968","38"
"1130","Demokratische und evangelische Fraktion (D)",6,3,9,"1 January 1968","38"
"1131","Fraktion der Partei der Arbeit (T)",5,0,5,"1 January 1968","38"
"1132","ohne Fraktionszugehörigkeit",1,0,1,"1 January 1968","38"
"1133","total",200,44,244,"1 January 1968","38"
"1137","Konservativ-christlichsoziale Fraktion (K)",45,18,63,"1 January 1969","38"
"1138","Radikal-demokratische Fraktion (R)",49,15,64,"1 January 1969","38"
"1139","Sozialdemokratische Fraktion (S)",51,2,53,"1 January 1969","38"
"1140","Bauern-, Gewerbe- und Bürgerfraktion (B)",21,3,24,"1 January 1969","38"
"1141","Fraktion des Landesrings (U)",16,1,17,"1 January 1969","38"
"1142","Liberal-demokratische Fraktion (L)",6,3,9,"1 January 1969","38"
"1143","Demokratische und evangelische Fraktion (D)",6,2,8,"1 January 1969","38"
"1144","Fraktion der Partei der Arbeit (T)",5,0,5,"1 January 1969","38"
"1145","ohne Fraktionszugehörigkeit",1,0,1,"1 January 1969","38"
"1146","total",200,44,244,"1 January 1969","38"
"1150","Konservativ-christlichsoziale Fraktion (K)",45,18,63,"1 January 1970","38"
"1151","Radikal-demokratische Fraktion (R)",49,15,64,"1 January 1970","38"
"1152","Sozialdemokratische Fraktion (S)",51,2,53,"1 January 1970","38"
"1153","Bauern-, Gewerbe- und Bürgerfraktion (B)",21,3,24,"1 January 1970","38"
"1154","Fraktion des Landesrings (U)",16,1,17,"1 January 1970","38"
"1155","Liberal-demokratische Fraktion (L)",6,3,9,"1 January 1970","38"
"1156","Demokratische und evangelische Fraktion (D)",6,2,8,"1 January 1970","38"
"1157","Fraktion der Partei der Arbeit (T)",5,0,5,"1 January 1970","38"
"1158","ohne Fraktionszugehörigkeit",1,0,1,"1 January 1970","38"
"1159","total",200,44,244,"1 January 1970","38"
"1163","Christlichdemokratische Fraktion (C)",45,17,62,"1 January 1971","38"
"1164","Radikal-demokratische Fraktion (R)",49,16,65,"1 January 1971","38"
"1165","Sozialdemokratische Fraktion (S)",51,2,53,"1 January 1971","38"
"1166","Bauern-, Gewerbe- und Bürgerfraktion (B)",21,3,24,"1 January 1971","38"
"1167","Fraktion des Landesrings (U)",16,1,17,"1 January 1971","38"
"1168","Liberal-demokratische Fraktion (L)",6,3,9,"1 January 1971","38"
"1169","Demokratische und evangelische Fraktion (D)",6,2,8,"1 January 1971","38"
"1170","Fraktion der Partei der Arbeit (T)",5,0,5,"1 January 1971","38"
"1171","ohne Fraktionszugehörigkeit",1,0,1,"1 January 1971","38"
"1172","total",200,44,244,"1 January 1971","38"
"1176","Radikal-demokratische Fraktion (R)",49,15,64,"1 January 1972","39"
"1177","Christlichdemokratische Fraktion (C)",44,17,61,"1 January 1972","39"
"1178","Sozialdemokratische Fraktion (S)",46,4,50,"1 January 1972","39"
"1179","Fraktion der Schweizerischen Volkspartei (V)",23,5,28,"1 January 1972","39"
"1180","Fraktion des Landesrings (U)",13,1,14,"1 January 1972","39"
"1181","Liberale und evangelische Fraktion (L)",9,2,11,"1 January 1972","39"
"1182","Fraktion der Republikaner (P)",7,0,7,"1 January 1972","39"
"1183","Fraktion der Partei der Arbeit (T)",5,0,5,"1 January 1972","39"
"1184","ohne Fraktionszugehörigkeit",4,0,4,"1 January 1972","39"
"1185","total",200,44,244,"1 January 1972","39"
"1189","Radikal-demokratische Fraktion (R)",49,15,64,"1 January 1973","39"
"1190","Christlichdemokratische Fraktion (C)",44,17,61,"1 January 1973","39"
"1191","Sozialdemokratische Fraktion (S)",46,4,50,"1 January 1973","39"
"1192","Fraktion der Schweizerischen Volkspartei (V)",23,5,28,"1 January 1973","39"
"1193","Fraktion des Landesrings (U)",13,1,14,"1 January 1973","39"
"1194","Liberale und evangelische Fraktion (L)",9,2,11,"1 January 1973","39"
"1195","Republikanische und nationale Fraktion (P)",11,0,11,"1 January 1973","39"
"1196","Fraktion der Partei der Arbeit (T)",5,0,5,"1 January 1973","39"
"1197","ohne Fraktionszugehörigkeit",0,0,0,"1 January 1973","39"
"1198","total",200,44,244,"1 January 1973","39"
"1202","Radikal-demokratische Fraktion (R)",49,15,64,"1 January 1974","39"
"1203","Christlichdemokratische Fraktion (C)",44,17,61,"1 January 1974","39"
"1204","Sozialdemokratische Fraktion (S)",46,4,50,"1 January 1974","39"
"1205","Fraktion der Schweizerischen Volkspartei (V)",23,5,28,"1 January 1974","39"
"1206","Fraktion des Landesrings (U)",13,1,14,"1 January 1974","39"
"1207","Liberale und evangelische Fraktion (L)",9,2,11,"1 January 1974","39"
"1208","Republikanische und nationale Fraktion (P)",11,0,11,"1 January 1974","39"
"1209","Fraktion der Partei der Arbeit (T)",5,0,5,"1 January 1974","39"
"1210","ohne Fraktionszugehörigkeit",0,0,0,"1 January 1974","39"
"1211","total",200,44,244,"1 January 1974","39"
"1215","Radikal-demokratische Fraktion (R)",49,15,64,"1 January 1975","39"
"1216","Christlichdemokratische Fraktion (C)",44,17,61,"1 January 1975","39"
"1217","Sozialdemokratische Fraktion (S)",46,4,50,"1 January 1975","39"
"1218","Fraktion der Schweizerischen Volkspartei (V)",23,5,28,"1 January 1975","39"
"1219","Fraktion des Landesrings (U)",13,1,14,"1 January 1975","39"
"1220","Liberale und evangelische Fraktion (L)",9,2,11,"1 January 1975","39"
"1221","Republikanische und nationale Fraktion (P)",7,0,7,"1 January 1975","39"
"1222","Fraktion der Partei der Arbeit (T)",5,0,5,"1 January 1975","39"
"1223","ohne Fraktionszugehörigkeit",4,0,4,"1 January 1975","39"
"1224","total",200,44,244,"1 January 1975","39"
"1228","Christlichdemokratische Fraktion (C)",46,17,63,"1 January 1976","40"
"1229","Freisinnig-demokratische Fraktion (R)",47,15,62,"1 January 1976","40"
"1230","Sozialdemokratische Fraktion (S)",55,5,60,"1 January 1976","40"
"1231","Fraktion der Schweizerischen Volkspartei (V)",21,5,26,"1 January 1976","40"
"1232","Fraktion des Landesrings (U)",11,1,12,"1 January 1976","40"
"1233","Liberale und evangelische Fraktion (L)",9,1,10,"1 January 1976","40"
"1234","Partei der Arbeit u. autonome sozialist. Partei (T)",5,0,5,"1 January 1976","40"
"1235","ohne Fraktionszugehörigkeit",6,0,6,"1 January 1976","40"
"1236","total",200,44,244,"1 January 1976","40"
"1240","Christlichdemokratische Fraktion (C)",46,17,63,"1 January 1977","40"
"1241","Freisinnig-demokratische Fraktion (R)",47,15,62,"1 January 1977","40"
"1242","Sozialdemokratische Fraktion (S)",55,5,60,"1 January 1977","40"
"1243","Fraktion der Schweizerischen Volkspartei (V)",21,5,26,"1 January 1977","40"
"1244","Fraktion des Landesrings (U)",11,1,12,"1 January 1977","40"
"1245","Liberale und evangelische Fraktion (L)",9,1,10,"1 January 1977","40"
"1246","Partei der Arbeit u. autonome sozialist. Partei (T)",5,0,5,"1 January 1977","40"
"1247","ohne Fraktionszugehörigkeit",6,0,6,"1 January 1977","40"
"1248","total",200,44,244,"1 January 1977","40"
"1252","Christlichdemokratische Fraktion (C)",46,17,63,"1 January 1978","40"
"1253","Freisinnig-demokratische Fraktion (R)",47,14,61,"1 January 1978","40"
"1254","Sozialdemokratische Fraktion (S)",55,6,61,"1 January 1978","40"
"1255","Fraktion der Schweizerischen Volkspartei (V)",21,5,26,"1 January 1978","40"
"1256","Fraktion des Landesrings (U)",11,1,12,"1 January 1978","40"
"1257","Liberale und evangelische Fraktion (L)",9,1,10,"1 January 1978","40"
"1258","Partei der Arbeit u. autonome sozialist. Partei (T)",5,0,5,"1 January 1978","40"
"1259","ohne Fraktionszugehörigkeit",6,0,6,"1 January 1978","40"
"1260","total",200,44,244,"1 January 1978","40"
"1264","Christlichdemokratische Fraktion (C)",46,17,63,"1 January 1979","40"
"1265","Freisinnig-demokratische Fraktion (R)",47,14,61,"1 January 1979","40"
"1266","Sozialdemokratische Fraktion (S)",55,7,62,"1 January 1979","40"
"1267","Fraktion der Schweizerischen Volkspartei (V)",21,4,25,"1 January 1979","40"
"1268","Fraktion des Landesrings (U)",11,1,12,"1 January 1979","40"
"1269","Liberale und evangelische Fraktion (L)",9,1,10,"1 January 1979","40"
"1270","Partei der Arbeit u. autonome sozialist. Partei (T)",5,0,5,"1 January 1979","40"
"1271","ohne Fraktionszugehörigkeit",6,0,6,"1 January 1979","40"
"1272","total",200,44,244,"1 January 1979","40"
"1276","Freisinnig-demokratische Fraktion (R)",51,11,62,"1 January 1980","41"
"1277","Christlichdemokratische Fraktion (C)",44,18,62,"1 January 1980","41"
"1278","Sozialdemokratische Fraktion (S)",51,9,60,"1 January 1980","41"
"1279","Fraktion der Schweizerischen Volkspartei (V)",23,5,28,"1 January 1980","41"
"1280","Unabhängige und evangelische Fraktion (UE)",11,0,11,"1 January 1980","41"
"1281","Liberale Fraktion (L)",8,3,11,"1 January 1980","41"
"1282","Fraktion der PdA, PSA, POCH (T)",7,0,7,"1 January 1980","41"
"1283","ohne Fraktionszugehörigkeit",5,0,5,"1 January 1980","41"
"1284","total",200,46,246,"1 January 1980","41"
"1288","Freisinnig-demokratische Fraktion (R)",51,11,62,"1 January 1981","41"
"1289","Christlichdemokratische Fraktion (C)",44,18,62,"1 January 1981","41"
"1290","Sozialdemokratische Fraktion (S)",51,9,60,"1 January 1981","41"
"1291","Fraktion der Schweizerischen Volkspartei (V)",23,5,28,"1 January 1981","41"
"1292","Unabhängige und evangelische Fraktion (UE)",11,0,11,"1 January 1981","41"
"1293","Liberale Fraktion (L)",8,3,11,"1 January 1981","41"
"1294","Fraktion der PdA, PSA, POCH (T)",7,0,7,"1 January 1981","41"
"1295","ohne Fraktionszugehörigkeit",5,0,5,"1 January 1981","41"
"1296","total",200,46,246,"1 January 1981","41"
"1300","Freisinnig-demokratische Fraktion (R)",51,11,62,"1 January 1982","41"
"1301","Christlichdemokratische Fraktion (C)",44,18,62,"1 January 1982","41"
"1302","Sozialdemokratische Fraktion (S)",51,9,60,"1 January 1982","41"
"1303","Fraktion der Schweizerischen Volkspartei (V)",23,5,28,"1 January 1982","41"
"1304","Unabhängige und evangelische Fraktion (UE)",11,0,11,"1 January 1982","41"
"1305","Liberale Fraktion (L)",8,3,11,"1 January 1982","41"
"1306","Fraktion der PdA, PSA, POCH (T)",7,0,7,"1 January 1982","41"
"1307","ohne Fraktionszugehörigkeit",5,0,5,"1 January 1982","41"
"1308","total",200,46,246,"1 January 1982","41"
"1312","Freisinnig-demokratische Fraktion (R)",51,11,62,"1 January 1983","41"
"1313","Christlichdemokratische Fraktion (C)",44,18,62,"1 January 1983","41"
"1314","Sozialdemokratische Fraktion (S)",51,9,60,"1 January 1983","41"
"1315","Fraktion der Schweizerischen Volkspartei (V)",23,5,28,"1 January 1983","41"
"1316","Unabhängige und evangelische Fraktion (UE)",11,0,11,"1 January 1983","41"
"1317","Liberale Fraktion (L)",8,3,11,"1 January 1983","41"
"1318","Fraktion der PdA, PSA, POCH (T)",7,0,7,"1 January 1983","41"
"1319","ohne Fraktionszugehörigkeit",5,0,5,"1 January 1983","41"
"1320","total",200,46,246,"1 January 1983","41"
"1324","Freisinnig-demokratische Fraktion (R)",54,14,68,"1 January 1984","42"
"1325","Christlichdemokratische Fraktion (C)",42,18,60,"1 January 1984","42"
"1326","Sozialdemokratische Fraktion (S)",47,6,53,"1 January 1984","42"
"1327","Fraktion der Schweizerischen Volkspartei (V)",23,5,28,"1 January 1984","42"
"1328","LdU/EVP-Fraktion (U)",12,0,12,"1 January 1984","42"
"1329","Liberale Fraktion (L)",8,3,11,"1 January 1984","42"
"1330","Fraktion der PdA, PSA, POCH (T)",5,0,5,"1 January 1984","42"
"1331","Fraktion der Nationalen Aktion / Vigilants (N)",5,0,5,"1 January 1984","42"
"1332","ohne Fraktionszugehörigkeit",4,0,4,"1 January 1984","42"
"1333","total",200,46,246,"1 January 1984","42"
"1337","Freisinnig-demokratische Fraktion (R)",54,14,68,"1 January 1985","42"
"1338","Christlichdemokratische Fraktion (C)",42,18,60,"1 January 1985","42"
"1339","Sozialdemokratische Fraktion (S)",47,6,53,"1 January 1985","42"
"1340","Fraktion der Schweizerischen Volkspartei (V)",23,5,28,"1 January 1985","42"
"1341","LdU/EVP-Fraktion (U)",12,0,12,"1 January 1985","42"
"1342","Liberale Fraktion (L)",8,3,11,"1 January 1985","42"
"1343","Fraktion der PdA, PSA, POCH (T)",5,0,5,"1 January 1985","42"
"1344","Fraktion der Nationalen Aktion / Vigilants (N)",5,0,5,"1 January 1985","42"
"1345","ohne Fraktionszugehörigkeit",4,0,4,"1 January 1985","42"
"1346","total",200,46,246,"1 January 1985","42"
"1350","Freisinnig-demokratische Fraktion (R)",54,14,68,"1 January 1986","42"
"1351","Christlichdemokratische Fraktion (C)",42,18,60,"1 January 1986","42"
"1352","Sozialdemokratische Fraktion (S)",47,6,53,"1 January 1986","42"
"1353","Fraktion der Schweizerischen Volkspartei (V)",23,5,28,"1 January 1986","42"
"1354","LdU/EVP-Fraktion (U)",12,0,12,"1 January 1986","42"
"1355","Liberale Fraktion (L)",8,3,11,"1 January 1986","42"
"1356","Fraktion der PdA, PSA, POCH (T)",5,0,5,"1 January 1986","42"
"1357","Fraktion der Nationalen Aktion / Vigilants (N)",5,0,5,"1 January 1986","42"
"1358","ohne Fraktionszugehörigkeit",4,0,4,"1 January 1986","42"
"1359","total",200,46,246,"1 January 1986","42"
"1363","Freisinnig-demokratische Fraktion (R)",54,14,68,"1 January 1987","42"
"1364","Christlichdemokratische Fraktion (C)",42,18,60,"1 January 1987","42"
"1365","Sozialdemokratische Fraktion (S)",47,6,53,"1 January 1987","42"
"1366","Fraktion der Schweizerischen Volkspartei (V)",23,5,28,"1 January 1987","42"
"1367","LdU/EVP-Fraktion (U)",13,0,13,"1 January 1987","42"
"1368","Liberale Fraktion (L)",8,3,11,"1 January 1987","42"
"1369","Fraktion der PdA, PSA, POCH (T)",5,0,5,"1 January 1987","42"
"1370","Fraktion der Nationalen Aktion / Vigilants (N)",0,0,0,"1 January 1987","42"
"1371","ohne Fraktionszugehörigkeit",8,0,8,"1 January 1987","42"
"1372","total",200,46,246,"1 January 1987","42"
"1376","Freisinnig-demokratische Fraktion (R)",51,14,65,"1 January 1988","43"
"1377","Christlichdemokratische Fraktion (C)",42,19,61,"1 January 1988","43"
"1378","Sozialdemokratische Fraktion (S)",42,5,47,"1 January 1988","43"
"1379","Fraktion der Schweizerischen Volkspartei (V)",25,4,29,"1 January 1988","43"
"1380","LdU/EVP-Fraktion (U)",12,1,13,"1 January 1988","43"
"1381","Liberale Fraktion (L)",9,3,12,"1 January 1988","43"
"1382","Grüne Fraktion (G)",9,0,9,"1 January 1988","43"
"1383","ohne Fraktionszugehörigkeit",10,0,10,"1 January 1988","43"
"1384","total",200,46,246,"1 January 1988","43"
"1388","Freisinnig-demokratische Fraktion (R)",44,18,62,"1 January 1992","44"
"1389","Christlichdemokratische Fraktion (C)",37,16,53,"1 January 1992","44"
"1390","Sozialdemokratische Fraktion (S)",43,3,46,"1 January 1992","44"
"1391","Fraktion der Schweizerischen Volkspartei (V)",25,4,29,"1 January 1992","44"
"1392","LdU/EVP-Fraktion (U)",9,1,10,"1 January 1992","44"
"1393","Liberale Fraktion (L)",10,3,13,"1 January 1992","44"
"1394","Grüne Fraktion (G)",14,0,14,"1 January 1992","44"
"1395","Fraktion der Autopartei (A)",8,0,8,"1 January 1992","44"
"1396","Fraktion Schweizer Demokraten u. Lega (D)",7,1,8,"1 January 1992","44"
"1397","ohne Fraktionszugehörigkeit",3,0,3,"1 January 1992","44"
"1398","total",200,46,246,"1 January 1992","44"
"1402","Freisinnig-demokratische Fraktion (R)",45,17,62,"1 January 1995","45"
"1403","Christlichdemokratische Fraktion (C)",34,16,50,"1 January 1995","45"
"1404","Sozialdemokratische Fraktion (S)",58,5,63,"1 January 1995","45"
"1405","Fraktion der Schweizerischen Volkspartei (V)",29,5,34,"1 January 1995","45"
"1406","LdU/EVP-Fraktion (U)",5,1,6,"1 January 1995","45"
"1407","Liberale Fraktion (L)",7,2,9,"1 January 1995","45"
"1408","Grüne Fraktion (G)",10,0,10,"1 January 1995","45"
"1409","Fraktion der Freiheitspartei (F)",8,0,8,"1 January 1995","45"
"1410","Fraktion Schweizer Demokraten u. Lega (D)",0,0,0,"1 January 1995","45"
"1411","ohne Fraktionszugehörigkeit",4,0,4,"1 January 1995","45"
"1412","total",200,46,246,"1 January 1995","45"
"1415","Freisinnig-demokratische Fraktion (R)",44,17,61,"1 January 1997","45"
"1416","Christlichdemokratische Fraktion (C)",34,16,50,"1 January 1997","45"
"1417","Sozialdemokratische Fraktion (S)",58,5,63,"1 January 1997","45"
"1418","Fraktion der Schweizerischen Volkspartei (V)",30,5,35,"1 January 1997","45"
"1419","LdU/EVP-Fraktion (U)",5,1,6,"1 January 1997","45"
"1420","Liberale Fraktion (L)",7,2,9,"1 January 1997","45"
"1421","Grüne Fraktion (G)",10,0,10,"1 January 1997","45"
"1422","Fraktion der Freiheitspartei (F)",6,0,6,"1 January 1997","45"
"1423","Fraktion Schweizer Demokraten u. Lega (D)",5,0,5,"1 January 1997","45"
"1424","ohne Fraktionszugehörigkeit",1,0,1,"1 January 1997","45"
"1425","total",200,46,246,"1 January 1997","45"
"1429","Freisinnig-demokratische Fraktion (R)",44,17,61,"1999 bis Ende der Legislatur","45"
"1430","Christlichdemokratische Fraktion (C)",34,15,49,"1999 bis Ende der Legislatur","45"
"1431","Sozialdemokratische Fraktion (S)",57,5,62,"1999 bis Ende der Legislatur","45"
"1432","Fraktion der Schweizerischen Volkspartei (V)",31,7,38,"1999 bis Ende der Legislatur","45"
"1433","LdU/EVP-Fraktion (U)",6,0,6,"1999 bis Ende der Legislatur","45"
"1434","Liberale Fraktion (L)",7,2,9,"1999 bis Ende der Legislatur","45"
"1435","Grüne Fraktion (G)",11,0,11,"1999 bis Ende der Legislatur","45"
"1436","Fraktion der Freiheitspartei (F)",9,0,9,"1999 bis Ende der Legislatur","45"
"1437","ohne Fraktionszugehörigkeit",1,0,1,"1999 bis Ende der Legislatur","45"
"1438","total",200,46,246,"1999 bis Ende der Legislatur","45"
"1442","Freisinnig-demokratische Fraktion (R)",43,18,61,"1 January 2000","46"
"1443","Christlichdemokratische Fraktion (C)",35,15,50,"1 January 2000","46"
"1444","Sozialdemokratische Fraktion (S)",53,6,59,"1 January 2000","46"
"1445","Fraktion der Schweizerischen Volkspartei (V)",44,7,51,"1 January 2000","46"
"1446","Evangelische und Unabhängige Fraktion (E)",5,0,5,"1 January 2000","46"
"1447","Liberale Fraktion (L)",6,0,6,"1 January 2000","46"
"1448","Grüne Fraktion (G)",10,0,10,"1 January 2000","46"
"1449","ohne Fraktionszugehörigkeit",4,0,4,"1 January 2000","46"
"1450","total",200,46,246,"1 January 2000","46"
"1454","Freisinnig-demokratische Fraktion (R)",42,18,60,"01.01.2002 bis zum Ende der Legislatur","46"
"1455","Christlichdemokratische Fraktion (C)",35,15,50,"01.01.2002 bis zum Ende der Legislatur","46"
"1456","Sozialdemokratische Fraktion (S)",52,6,58,"01.01.2002 bis zum Ende der Legislatur","46"
"1457","Fraktion der Schweizerischen Volkspartei (V)",45,7,52,"01.01.2002 bis zum Ende der Legislatur","46"
"1458","Evangelische und Unabhängige Fraktion (E)",5,0,5,"01.01.2002 bis zum Ende der Legislatur","46"
"1459","Liberale Fraktion (L)",6,0,6,"01.01.2002 bis zum Ende der Legislatur","46"
"1460","Grüne Fraktion (G)",10,0,10,"01.01.2002 bis zum Ende der Legislatur","46"
"1461","ohne Fraktionszugehörigkeit",5,0,5,"01.01.2002 bis zum Ende der Legislatur","46"
"1462","total",200,46,246,"01.01.2002 bis zum Ende der Legislatur","46"
"1465","Fraktion FDP-Liberale (RL)",40,14,54,"1 January 2004","47"
"1466","Christlichdemokratische Fraktion (C)",28,15,43,"1 January 2004","47"
"1467","Sozialdemokratische Fraktion (S)",52,9,61,"1 January 2004","47"
"1468","Fraktion der Schweizerischen Volkspartei (V)",56,8,64,"1 January 2004","47"
"1469","EVP/EDU-Fraktion (E)",5,0,5,"1 January 2004","47"
"1470","Grüne Fraktion (G)",15,0,15,"1 January 2004","47"
"1471","ohne Fraktionszugehörigkeit",4,0,4,"1 January 2004","47"
"1472","total",200,46,246,"1 January 2004","47"
"1476","Fraktion FDP-Liberale (RL)",40,14,54,"18.04.2004 bis zum Ende der Legislatur","47"
"1477","Christlichdemokratische Fraktion (C)",28,15,43,"18.04.2004 bis zum Ende der Legislatur","47"
"1478","Sozialdemokratische Fraktion (S)",52,9,61,"18.04.2004 bis zum Ende der Legislatur","47"
"1479","Fraktion der Schweizerischen Volkspartei (V)",56,8,64,"18.04.2004 bis zum Ende der Legislatur","47"
"1480","EVP/EDU-Fraktion (E)",5,0,5,"18.04.2004 bis zum Ende der Legislatur","47"
"1481","Grüne Fraktion (G)",14,0,14,"18.04.2004 bis zum Ende der Legislatur","47"
"1482","ohne Fraktionszugehörigkeit",5,0,5,"18.04.2004 bis zum Ende der Legislatur","47"
"1483","total",200,46,246,"18.04.2004 bis zum Ende der Legislatur","47"
"1486","Fraktion FDP-Liberale (RL)",35,12,47,"1 January 2008","48"
"1487","CVP/EVP/glp (CEg)",36,16,52,"1 January 2008","48"
"1488","Sozialdemokratische Fraktion (S)",43,9,52,"1 January 2008","48"
"1489","Fraktion der Schweizerischen Volkspartei (V)",64,7,71,"1 January 2008","48"
"1490","Grüne Fraktion (G)",22,2,24,"1 January 2008","48"
"1491","total",200,46,246,"1 January 2008","48"
"1495","Fraktion FDP-Liberale (RL)",35,12,47,"18.12.2007-15.09. 2008","48"
"1496","CVP/EVP/glp (CEg)",36,16,52,"18.12.2007-15.09. 2008","48"
"1497","Sozialdemokratische Fraktion (S)",43,9,52,"18.12.2007-15.09. 2008","48"
"1498","Fraktion der Schweizerischen Volkspartei (V)",63,7,70,"18.12.2007-15.09. 2008","48"
"1499","Grüne Fraktion (G)",22,2,24,"18.12.2007-15.09. 2008","48"
"1500","ohne Fraktionszugehörigkeit",1,0,1,"18.12.2007-15.09. 2008","48"
"1501","total",200,46,246,"18.12.2007-15.09. 2008","48"
"1505","Fraktion FDP-Liberale (RL)",35,12,47,"15.09.2008-02.03.2009","48"
"1506","CVP/EVP/glp (CEg)",36,16,52,"15.09.2008-02.03.2009","48"
"1507","Sozialdemokratische Fraktion (S)",43,9,52,"15.09.2008-02.03.2009","48"
"1508","Fraktion der Schweizerischen Volkspartei (V)",59,6,65,"15.09.2008-02.03.2009","48"
"1509","Grüne Fraktion (G)",22,2,24,"15.09.2008-02.03.2009","48"
"1510","ohne Fraktionszugehörigkeit",5,1,6,"15.09.2008-02.03.2009","48"
"1511","total",200,46,246,"15.09.2008-02.03.2009","48"
"1515","Fraktion FDP-Liberale (RL)",35,12,47,"02.03.2009-07.09.2009","48"
"1516","CVP/EVP/glp (CEg)",36,16,52,"02.03.2009-07.09.2009","48"
"1517","Sozialdemokratische Fraktion (S)",43,9,52,"02.03.2009-07.09.2009","48"
"1518","Fraktion der Schweizerischen Volkspartei (V)",59,6,65,"02.03.2009-07.09.2009","48"
"1519","Grüne Fraktion (G)",22,2,24,"02.03.2009-07.09.2009","48"
"1520","Fraktion der Bürgerl.-Demokr. Partei (BD)",4,1,5,"02.03.2009-07.09.2009","48"
"1521","ohne Fraktionszugehörigkeit",1,0,1,"02.03.2009-07.09.2009","48"
"1522","total",200,46,246,"02.03.2009-07.09.2009","48"
"1526","Fraktion FDP-Liberale (RL)",35,12,47,"07.09.2009-16.11.2010","48"
"1527","CVP/EVP/glp (CEg)",36,16,52,"07.09.2009-16.11.2010","48"
"1528","Sozialdemokratische Fraktion (S)",42,9,51,"07.09.2009-16.11.2010","48"
"1529","Fraktion der Schweizerischen Volkspartei (V)",60,6,66,"07.09.2009-16.11.2010","48"
"1530","Grüne Fraktion (G)",22,2,24,"07.09.2009-16.11.2010","48"
"1531","Fraktion der Bürgerl.-Demokr. Partei (BD)",5,1,6,"07.09.2009-16.11.2010","48"
"1532","total",200,46,246,"07.09.2009-16.11.2010","48"
"1536","Fraktion FDP-Liberale (RL)",35,12,47,"16.11.2010-14.02.2011","48"
"1537","CVP/EVP/glp (CEg)",36,16,52,"16.11.2010-14.02.2011","48"
"1538","Sozialdemokratische Fraktion (S)",41,9,50,"16.11.2010-14.02.2011","48"
"1539","Fraktion der Schweizerischen Volkspartei (V)",60,6,66,"16.11.2010-14.02.2011","48"
"1540","Grüne Fraktion (G)",22,2,24,"16.11.2010-14.02.2011","48"
"1541","Fraktion der Bürgerl.-Demokr. Partei (BD)",5,1,6,"16.11.2010-14.02.2011","48"
"1542","ohne Fraktionszugehörigkeit",1,0,1,"16.11.2010-14.02.2011","48"
"1543","total",200,46,246,"16.11.2010-14.02.2011","48"
"1547","Fraktion FDP-Liberale (RL)",35,12,47,"14.02.2011-05.03.2011","48"
"1548","CVP/EVP/glp (CEg)",35,16,51,"14.02.2011-05.03.2011","48"
"1549","Sozialdemokratische Fraktion (S)",41,9,50,"14.02.2011-05.03.2011","48"
"1550","Fraktion der Schweizerischen Volkspartei (V)",61,6,67,"14.02.2011-05.03.2011","48"
"1551","Grüne Fraktion (G)",22,2,24,"14.02.2011-05.03.2011","48"
"1552","Fraktion der Bürgerl.-Demokr. Partei (BD)",5,1,6,"14.02.2011-05.03.2011","48"
"1553","ohne Fraktionszugehörigkeit",1,0,1,"14.02.2011-05.03.2011","48"
"1554","total",200,46,246,"14.02.2011-05.03.2011","48"
"1558","Fraktion FDP-Liberale (RL)",35,12,47,"06.03.2011 bis zum Ende der Legislatur","48"
"1559","CVP/EVP/glp (CEg)",35,16,51,"06.03.2011 bis zum Ende der Legislatur","48"
"1560","Sozialdemokratische Fraktion (S)",41,8,49,"06.03.2011 bis zum Ende der Legislatur","48"
"1561","Fraktion der Schweizerischen Volkspartei (V)",61,7,68,"06.03.2011 bis zum Ende der Legislatur","48"
"1562","Grüne Fraktion (G)",22,2,24,"06.03.2011 bis zum Ende der Legislatur","48"
"1563","Fraktion der Bürgerl.-Demokr. Partei (BD)",5,1,6,"06.03.2011 bis zum Ende der Legislatur","48"
"1564","ohne Fraktionszugehörigkeit",1,0,1,"06.03.2011 bis zum Ende der Legislatur","48"
"1565","total",200,46,246,"06.03.2011 bis zum Ende der Legislatur","48"
"1569","Fraktion FDP-Liberale (RL)",30,11,41,"1 January 2012","49"
"1570","CVP/EVP (CE)",31,13,44,"1 January 2012","49"
"1571","Sozialdemokratische Fraktion (S)",46,11,57,"1 January 2012","49"
"1572","Fraktion der Schweizerischen Volkspartei (V)",56,6,62,"1 January 2012","49"
"1573","Grüne Fraktion (G)",15,2,17,"1 January 2012","49"
"1574","Grünliberale Fraktion (GL)",12,2,14,"1 January 2012","49"
"1575","Fraktion der Bürgerl.-Demokr. Partei (BD)",9,1,10,"1 January 2012","49"
"1576","ohne Fraktionszugehörigkeit",1,0,1,"1 January 2012","49"
"1577","total",200,46,246,"1 January 2012","49"
